000000000000000000000000000000000000000000000000052000000000000000000000000000000000000000000000
000000000000000000000000014000000000000000000000052000014014014014014014000000000000000000000000
000000000000000000014014014014000000000000000000052014014014014014014014000000000000013013000000
000000000000000014014014014014000000000000000000052014014014014014014014000000000000013013000000
000000000000000000000014014000000000000000000000052052014014014014000000000000000000000000000000
000000000000000000000000000000000000000000000000000052014014014000000000000000000000000000000000
000000000000000000000000000000000000000000000000000052000000000000000000000000000000000000000000
000000000000000000000000000000000000000000000000000052000000000000000000000000000000000000000000
000000000000000000000000000000000000000000000000000052000000000000000000000000000000000000000000
000000000000000000000000000000000000000000000000000052000000000000000000000000000000000000000000
000000000000000000000000000000000000000000000000000052000000000000000000000000000000000000000000
000000000000000000000000000000000000000000000000000052000000000000000000000000000000000000000000
000000000000000000000000000000000000000000000000000052000000000000000000000000000000000000000000
003003003003003003003003003003003003003003003003003012012012012012012012012012012012012012012012
003003003003003003003003003003003003003003003003003003003003012012012012012012012012012012012012
003003003003003003003003003003003003003003003003003003003003003003003012012012012012012012012012
003003003003003003003003003003003003003003003003003003003003003003003003003003012012012012012012
003003003003003003003003003003003003003003003003003003003003003003003003003003003003012012012012
