033033033033033033033033033033033033033033033033033033033033033033033033033033033033033033033033033033033033033033033033033033033033033033033033
033033033033033033033033033033033033033033033033033033033033033033033033033033033033033033033033033033033033033033033033033033033033033033033033
033033033033033033033033033033033033033033033033033033033033033033033033033033033033033033033033033033033033033033033033033033033033033033033033
033033033033033033033033033033033033033033033034034034034034034034034034034034034034034034034034034034034034034034034034034034034034033033033033
033033033033033033033033033033033033034034034034034034034034034034034034034034034034034034034034034034034034034034034034034034034034033033033033
033033033033033033033033033033033033034034034034034034034034034034034034034034034034034034034034034034034034034034034034034007007034033033033033
033033033033033033033033033033033033034034034034034034034034034034034034034034034034034034034034034034034034034034034034034007007034033033033033
033033033033033033034034034034034034034034034034034034034034034034034034034034034034034034034034034034034034034034034034034007007034033033033033
033033033033033034034034034034034034034034034034034034034034034034034034034034034034034034034034034034034034033033033033033033033033033033033033
033033033033033034034034034034034034034034034034034034034034034034034034034034034034034034034034034033033034033033033033033033033033033033033033
033033033033033034034034034034034034034034034034034034034034034034034034034034034034034034034034033033034034033033033033033033033033033033033033
033033033033033034034034034033033033033033033034034034034034034034034034034034034034034034034034033034034034033033033033033033033033033033033033
033033033033033034034034033033033033033034034034034034034033034034033033033033034034034034033034033034034034033033033033033033033033033033033033
033033033033033034034034034034034033034034034034034033033033034034034034034034034034034034033034034034034034033033033033033033033033033033033033
033033033033033033034034034034034034034034034034034034034034034034034034034034034034034034034034034034034034033033033033033033033033033033033033
033033033033033033034034034034034034034034034034034034034034034034034034034034034034034034034034034034034034033033033033033033033033033033033033
033033033033033033033034034034034034034034034034034034034034034034034034034034034034034034034034034034034034033033033033033033033033033033033033
033033033033033033033033033033034034034034034034034034034034034034034034034034034034034034034034034034034034033033033033033033033033033033033033
033033033033033033033033033033033033034034034034034034034034034034034034034034034034034034034034034034034034033033033033033033033033033033033033
033033033033033033033033033033033033034034034034034034034034034034034034034034034034034034034034034034034034033033033033033033033033033033033033
033033033033033033033033033033033033034034034034034034034034034034034034034034034034034034034034034034034034033033033033033033033033033033033033
033033033033033033033033033033033033034033034034034034034034034034034034034034034034034034034034034034034034033033033033033033033033033033033033
033033033033033033033033033033033033034033034034034034034034034034034034034034034034034034034034034034034034033033033033033033033033033033033033
033033033033033033033033033033033033034033033034034034034034034034034034034034034034034034034034034034034034033033033033033033033033033033033033
033033033033033033033033033033033033034034034034034034034034034034034034034034034034034034034034034034034034033033033033033033033033033033033033
033033033033033033033033033033033034034034034034033033034034034034034034034034034034034034034034034034034034034033033033033033033033033033033033
033033033033033033033033033033033034034034034034034034034034034034034034034034034034034034034034034034034034034033033033033033033033033033033033
033033033033033033033033033033034034034034034034034034034033033034034034034034034034034034034034034034034034034034033033033033033033033033033033
034034034034034034034034034034034034034034034034034034034034034034034034034034034034034034034034034034034034034034034034034034034034034034034034
034034034034034034034034034034034034034034034034034034034034034034034034034034034034034034034034034034034034034034034034034034034034034034034034
034034034034034034034034034034034034034034034034034034034034034034034033034034034034034034034034034034034034034034034034034034034034034034034034
034034034034034034034034034034034034034034034034034034034034034034034033034034034034034034034034034034034034034034034034034034034034034034034034
034034034034034034034034034034034034034034034034034034034034033033033033033034034034034034034034034034034034034034034034034034034034034034034034
033033033033033033033033033033033033034034034034034034034034033034034034034034034034033033033034034034034034033033033033033033033033033033033033
033033033033033033033033033033033033034034033033033033034034034034034034034033033034034034033033034034033033033033033033033033033033033033033033
033033033033033033033033033033033033034034034033033034034034034034034034034034034034034034034034034034034034033033033033033033033033033033033033
