033033033033033033033033033033033033033033033033033033033033033033033033033033033033033033033033
033033033033033033033033033033033033033033033033033033033033033033033033033033033033033033033033
033033033033033033033033033033033033033033033033033033033033033033033033033033033033033033033033
033033033033033033033033033033033033033033033033033033033033033033033033033033033033033033033033
033033033033033033033033033033033033033033033033033033033033033033033033033033033033033033033033
033033033033033033033033033033033033033033033033033033033033033033033033033033033033033033033033
033033033033033033033033033033033033033033033033033033033033033033033033033033033033033033033033
033033033033033033033033033033033033033033033033033033033033033033033033033033033033033033033033
033033033033033034034034034034034034034034034034034034034034034034034034034034034033033033033033
033033034034034034034034034034034034034034034034034034034034034034034034034034034034034033033033
034034034034034034034034034034034034034034034034034034034034034034034034034034034034034034033033
034034034034034034034034034034034034034034034034034034034034034034034034034034034034034034034033
034034034034034034034034034034034034034034034034034034034034034034034034034034034034034034034034
034034034034034034034034034034034034034034034034034034034034034034034034034034034034034034034034
034034034034034034034034034034034034034034034034034034034034034034034034034034034034034034034034
033033033033033033033033033033033033033033033033033033033033033033033033033033033033033033033033
033033033033033033033033033033033033033033033033033033033033033033033033033033033033033033033033
033033033033033033033033033033033033033033033033033033033033033033033033033033033033033033033033
