033033033033033033033033033033033033033033033033033033033033033033033033033033033033033033033033033033033033033033033033033033033033033033033033
033033033033033033033033033033033033033033033033033033033033033033033033033033033033033033033033033033033033033033033033033033033033033033033033
033033033033033033033033033033033033033033033033033033033033033033033033033033033033033033033033033033033033033033033033033033033033033033033033
033033033033033033033033033033033033033033033033033033033033033033033033033033033033033033033033033033033033033033033033033033033033033033033033
033033033033033033033033033033033033033033033033033033033033033033033033033033033033033033033033033033033033033033033033033033033033033033033033
033033033033033033033033033033033033033033033033033033033033033033033033033033033033033033033033033033033033033033033033033033033033033033033033
033033033033033033033033033033033033033033033033033033033033033033033033033033033033033033033033033033033033033033033033033033033033033033033033
033033033033033033033033033033033033033033033033033033033033033033033033033033033033033033033033033033033033033033033033033033033033033033033033
033033033033033033033033033033033033033033033033033033033033033033033033033033033033033033033033033033033033033033033033033033033033033033033033
033033034034034034034034034041042042034034034034034034042042034034041034034034042042034034041034041034042042041034041034041034042042034041033033
033033034041041034034034041034042042041034034041034041042042034041034034041034042042041034034034034034042042034041034034034034042042041034033033
033033034034034034034034034034042042034041034034041041042042034034034034041034042042034041034041034041042042034034034041041034042042041041033033
007034034034034034041041034034042042034041041034034034042042034034034041034034042042034034041041034034042042041034041034034034042042041041033033
007034034034034034034034041041042042041034041034041034042042041034041034041034042042034041034034041041042042034041041041041034042042041034033033
007034034034034034034034041034042042034034034041034034042042034034034034041041042042034034041034034041042042034034041034034041042042034041033033
033033033033033033033033033033033033033033033033033033033033033033033033033033033033033033033033033033033033033033033033033033033033033033033033
033033033033033033033033033033033033033033033033033033033033033033033033033033033033033033033033033033033033033033033033033033033033033033033033
033033033033033033033033033033033033033033033033033033033033033033033033033033033033033033033033033033033033033033033033033033033033033033033033
033033033033033033033033033033033033033033033033033033033033033033033033033033033033033033033033033033033033033033033033033033033033033033033033
033033033033033033033033033033033033033033033033033033033033033033033033033033033033033033033033033033033033033033033033033033033033033033033033
033033033033033033033033033033033033033033033033033033033033033033033033033033033033033033033033033033033033033033033033033033033033033033033033
033033033033033033033033033033033033033033033033033033033033033033033033033033033033033033033033033033033033033033033033033033033033033033033033
033033033033033033033033033033033033033033033033033033033033033033033033033033033033033033033033033033033033033033033033033033033033033033033033
033033033033033033033033033033033033033033033033033033033033033033033033033033033033033033033033033033033033033033033033033033033033033033033033
033033033033033033033033033033033033033033033033033033033033033033033033033033033033033033033033033033033033033033033033033033033033033033033033
033033033033033033033033033033033033033033033033033033033033033033033033033033033033033033033033033033033033033033033033033033033033033033033033
