000000000000000000000000000000000000000000000000000000000000000000000000000000000000000000000000000000000000000000000000000000000000000000000000000000000000000000000000000000000000000000000000
000000014014014000000000000014014014014000000000000000000000000000014014014000000000000014014014014014014000000000000000000000000000014014014014014000000000000000028000000000000000000000000000
000000014014014000000000000014014000000000000000000000000000000014014014014000000000014014014014000000000000000000000000000000000000000014014014014000000000000000023000000000000000000000000000
000000000000000000000000000000000000000000000000000000000000000000000000000000000000014014000000000000000000000000014014000000000000000000000000000000000000000000023000000000000000000000000000
000000000014014000000000000000000000000000000014014000000000000000000000000000000000000000000000000000000000000000000014000000000000000000000000000000000000000024023025000000000000000000000000
000000000000000000000000000000000000000000000000000000000000000000000000000000000000000000000000000000000000000000000000000000000000000000000000000000000000021023023023022000000000000000000000
036036036036036036036036036044044044044044044044044044044044046046036036036036036036036036036036036036036036036036036036036036036036036036036036036036036036021023027023022036036036036036036036
036036036036036036036036036044044044044044044044044044044044046046036036036036036036036036036036036036036036036036036036036036036036036036036036036036036036021023027023022036036036036036036036
036036036036036036036036036045044046046044044044046046044044046046036036036036036036036036036036036036036036036036036036036036036036036036036036036036036036021023027023022036036036036036036036
036036036036036036036036036044044044044044044044044044044044046046046036036036036036036036036036036036036036036036036036036036036036036036036036047011011011021023023023022011011011048036036036
036036036036036036036036044044044044044044044044044044044044044046046036036036036004004004004004004004004004004004004004037037036036036036047011011011011011021023023023022011011011011011048036
036036036036036036036036044044044044044044044044044044044044044046046036036036036004020020004004004004004020004004019004037037036036036036011011027011027011021023023023022011027011027011011036
008008008008008066008008044044046046044044007044044046046044044046046008008008008004004037037004004007004004037037004004037037008008008008011011027011027011021023015023022011027011027011011008
008008008008008067008008044044044044044044007044044044044044044046046008008008008019004004004004019007004019004004004004037037008008008008011011011011011011021023016023022011011011011011011008
002002002002002002002002002002002002002002002002002002002002002002002002002002002002002002002002002002002002002002002002002002002002002002002002002002002002002002002002002002002002002002002002
002002002002002002002002002002002002002002002002002002002002002002002002002002002002002002002002002002002002002002002002002002002002002002002002002002002002002002002002002002002002002002002002
002002002002002002002002002002002002002002002002002002002002002002002002002002002002002002002002002002002002002002002002002002002002002002002002002002002002002002002002002002002002002002002002
002002002002002002002002002002002002002002002002002002002002002002002002002002002002002002002002002002002002002002002002002002002002002002002002002002002002002002002002002002002002002002002002
