000000000000000000000000000000000000000000000000000000000000000000000000000000000000000000000000000000000000000000000000000000052000000000000000000000000000000000000000000000000000000000000000
000000000000000000000000000000000000000000000000000000000000000000000000000000000000000000000000000000000000000000000000000000052000000000000000000000000000000000000000000000000000000000000000
000000000000000000000000000000000000000000000000000000000000000000000000000000000000000000000000000000000000000000000000000000052000000000000000000000000000000000000000000000000000000000000000
000000000000000000000000000000000000000000000000000000000000000000000000000000000000000000000000000000000000000000000000000000052000000000000000000000000000000000000000000000000000000000000000
000000000000000000000000000000000000000000000000000000000000000000000000000000000000000000000000000000000000000000000000000000052000000000000000000000000000000000000000000000000000000000000000
000000000000000000000000000000000000000000000000000000000000000000000000000000000000000000000000000000000000000000000000000000052000000000000000000000000000000000000000000000000000000000000000
036036036036036036036036036036036036036036036036036036036036036036036036036036036036036036036036036036036036036036036036036036059036036036036036036036036036036036036036036036036036036036036036
036037004004004004004004004004004004004036036036036036036036036036036036036036036036036036036036036036036036036036036036036036059036036036036036036036036036036036036036036036036036036036036036
036037004006006006006006006006006039004036036036036036036036036036036036036036036036036036036036036036036036036036036036036036059036036036036036036036036036036036036036036036036036036036036036
036037004040040040040040040040040040015036036036036036036036036036036036036036036036036036036036036036036036036036036036036036059036036036036036036036036036036036036036036036036036036036036036
036037004006006006006006006006006006016042006036036036036036036036036036036036036036036036036036036036036036036036036036036036059036036036036036036036036036036036036036036036036036036036036036
036037004040040040040040040040040040004040040036036036036036036036036036036036036036036036036036036036036036036036036036036036059036036036036036036036036036036036036036036036036036036036036036
008037004006006006006015006006006006004036036036036036036036036036036036036036036036036036036036036036036036036036036036036036059036036036036036036036036036036036036036036036036036036036036036
008037004040040040040016040040040040004036036036036036036036036036036036036036036036036036036036036036036036036036036036036036036036036036036036036036036036036036036036036036036036036036036036
002002002002002002002002002002002002002002002002035035035035035035035035035035035035035035035035035035035035035035035035035035040036036036036036036036036036036036036036036036036036036036036036
002002002002002002002002002002002002002002002002035035035035035035035035035035035035035035035035035035035035035035035035035035035036036036036036036036036036036036036036036036036036036036036036
002002002002002002002002002002002002002002002002035035035035035035035035035035035035035035035035035035035035035035035035035035035036036036036036036036036036036036036036036036036036036036036036
002002002002002002002002002002002002002002002002035035035035035040035035035035035035035035035035035035035035035035035035035035035036036036036036036036036036036036036036036036036036036036036036
