000000000000000000000000000000000000000000000000000000000000000000000000000000000000000000000000000000000000000000000000000000000000000000000000
000000000000000000000000000000000000000000000000000014014000000000000000000000000000000000000000000000000000000000000000000000000000000000000000
051000000000000000000000000000000000000000000014014014014014014000000000000000000051051000000000014000000014014000000000000000000000000000000000
051014014014000000000000000000000000000000000014014014014014000000000000000000000051051000000000014014014014014000000000000000000000000000000000
051014014014000000000000000000000000000000000000000000000000000000000000000000000051051000000000000000000000000000000000000000000000000000000000
051000014000000000000000000000000000000000000000000000000000000000000000000000000051051000000000000000000000000000000000000000000000000000000000
051051000000000000000000000000000000000000000000000000000000000000000000000000051051051051000000000000000000000000000000000000000000000000000000
051051000000000000000000000000000000000000000000000000000000000000000000000000051051051051000000000000000000000000000000000000000000000000000000
051051000000000000000000000014014014014014000000000000000000000000000000000000032032032032000000000000000000000000000000014014014000000000000000
051051000000000000000000000014014014014014000000000051051051051051000000000000032032032032000000000000000000000000000000014014014014000000000000
051051000000000000000000000000014014014000000000051051032061061061000000000000032032032032000000000000000000000000000000000000000000000000000000
051051000000000000000000000000000000000000000051051032032032032032000000000000032032032032032032032032032032032032032032032032032032032032032032
051051051051051051051051051051051051051051051051032032032032032032032032032051051051051051051051051051051051051051051051051051051051051051051051
051051051051051051051051051051051051051051051032032032032032032032032032051051051051051051051051051051051051051051051051051051051051051051051051
051051051051051051051051051051051051051051032032032032032051051051051051051051051051051051014014000000000000000000000000000000000000000000000000
051051000000000000000000000000000061061061032000000000000000032000000000000000051051051051000000000000000000000000000000000000000000000000000000
051051000000000000000000000000032032032032032000000000000000032000000000000000051051051051000000000000000000000000000000000000000000000000000000
051051000000000000000000000000032032032032032000000000000000032000000000000000051051051051000000000000000000000000000000000000000000000000000000
051051000000000000000000000000032032032032032000000000000000032000000000000000051051051051000000000000000000000000000000014014000000000000000000
051051000000000000000000000000032051051051051000000000000000032000000000000000051051051051000000000000000000000000000014014014000000000000000000
051051000000000014014000000000000000032000000000000000000000032000000014000000051051051051000000000000000000000000000000000000000000000000000000
051051000000000000000000000000000000032000000000000000000000032000014014000000051051051051000000014014000000000000000000000000000000000000000000
032032000000000000000000000000000000032000000000000000000000032000000000000000032032032032000000000000000000000000000000000000000000000000000000
032032036036036036036036036036036036032036036036036036036036032036036036036036032032032032036036036036036036036036036036036036036036036036036036
032032036036036036036036036036036036032036036036036036036036032036036036036036032032032032036036036036036036036036036036036036036036036036036036
032032032032032032032032032032032032032032032032032032032032032032032032032032032032032032032036036036036036036036036036036036036036032032032032
051051051051051051051051051051051051051051051051051051051051051051051051051051051051051051051036036036036036036036036036036051051051051051051051
051051051051051051051051051051051051051051051051051051051051051051051051051051051051051051051036036036036036036036036036051051051051051051051051
051051051051051051051051051051051051051051051051051051051051051051051051051051051051051051051051012012012012012012012012012051051051051051051051
051051051051051051051051051051051051051051051051051051051051051051051051051051051051051051051051012012012012012012012012012012012051051051051051
012012051051051051012012012012012012012012012012012012012012012012012012012012051051051051012012012012012012012012012012012012012012012012012012
012012051051051051012012012012012012012012012012012012012012012012012012012012051051051051012012012012012012012012012012012012012012012012012012
012012051051051051012012012012012012012012012012012012012012012012012012012012051051051051012012012012012012012012012012012012012012012012012012
012012051051051051012012012012012012012012012012012012012012012012012012012012051051051051012012012012012012012012012012012012012012012012012012
012012051051051051012012012012012012012012012012012012012012012012012012012012051051051051012012012012012012012012012012012012012012012012012012
012012051051051051012012012012012012012012012012012012012012012012012012012012051051051051012012012012012012012012012012012012012012012012012012
