000000000000000000000000000000000000000000000000000000000000000000000000000000000000000000000000000000000000000000000000000000000000000000000000
000000000000000000000000000000000000000000000000000014014000000000000000000000000000000000000000000000000000000000000000000000000000014014014014
000000000000000000000000000000000000000000014014014014014051051000000000000000000000000014014014014000000014014000000000000000000014014014014014
000014014014000000000000000000000000000000014014014014014051051000000000000000000000000014014014014014014014014000000000000000000014014014014014
000014014014000000000000000000000000000000000000000000000051051000000000000000000000000014014014014014014014014000000000000000000014014014014014
000000014014000000000000000000000000000000000000000000000051051000000000000000000000000000014014014014014014000000000000000000014014014014014014
000000000014000000000000000000000000014014000000000000051051051051000000000000000000000000000000000000000000000000000000000000014014014014014014
000000000000000000000000000000000014014014014000000000051051061061000000000000000000000000000000000000000000000000000000000000000000000000000000
000000000000000000000000000014014014014014014000000000032032032032000000000000000000000000014014014014014000000000000000014014014000000000000000
000000000000000000000000000014014014014014000000000000032032032032000000000000000000000000014014014014014000000000000000014014014014000000000000
000000000000000000000000000000000000000000000000000000032032032032000000000000061061061000000014014014000000000000000000000014014014000000000000
032032032032032032032032032032032032032032032032032032032032032032000000000032032032032032000000000000000000000000000000000000000000000000000000
051051051051051051051051051051051051051051051051051051051051051051000000000032032032032032000000000000000000000000000000000000000000000000000000
051051051051051051051051051051051051051051051051051051051051051051000000000032032032032032000000000000000000000000000000000014014014000000000000
000000014014014000000000000000000000000000000000000000051051051051000000000051051051051032014014000000000000000000000000000000014014014000000000
000000014000000000000000000000000000000000000000000000051051051051000000000000000032000000000000000000061061061000000000000000000000000000000000
000000000000000000000000000000000000000000000000000000051051051051000000000000000032000000000000000032032032032032000000000000000000000000000000
000000000000000000000000000000000000014014014000000000051051051051000000000000000032000000000000000032032032032032000000000000000000000000000000
000000000000000000000000000000000000000014014000000000051051051051000000000000000032000000000000000032032032032032000000000000000000000000000000
000000000000000000000000000000000000000000000000000000051051051051000000000000000032000000000000000051051051051032000014014000000000000000000000
000000000000000014014000000000000000000000000000000000051051051051000000000000000032000000000000000000000032000000000000000000000000000000000000
000000000000000000000000000000000000000000000000000000051051051051000000000000000032000000000000014014000032000000000000000000000014014014000000
000000000000000000000000000000000000000000000000000000032032032049000000000000000032000000000000000000000032000000000000000000000000000000000000
036036036036036036036036036036036036036036036036036036032032032049036036036036036032036036036036036036036032036036036036036036036036036036036036
036036036036036036036036036036036036036036036036036036032032032049036036036036036032036036036036036036036032036036036036036036036036036036036036
032032032032032032032032032032032032032032032032032032032032032049032032032032032032032032032032032032032032032032032032032032032032032032032032
051051051051051051051051051051051051051051051051051051051051051051051051051051051051051051051051051051051051051051051051051051051051051051051051
051051051051051051051051051051051051051051051051051051051051051051051051051051051051051051051051051051051051051051051051051051051051051051051051
051051051051051051051051051051051051051051051051051051051051051051051051051051051051051051051051051051051051051051051051051051051051051051051051
051051051051051051051051051051051051051051051051051051051051051051051051051051051051051051051051051051051051051051051051051051051051051051051051
012012051051051051012012012012012012012012012012012012012012012012012012012012051051051051012012012012012012012012012012012012012012012012012012
012012051051051051012012012012012012012012012012012012012012012012012012012012051051051051012012012012012012012012012012012012012012012012012012
012012051051051051012012012012012012012012012012012012012012012012012012012012051051051051012012012012012012012012012012012012012012012012012012
012012051051051051012012012012012012012012012012012012012012012012012012012012051051051051012012012012012012012012012012012012012012012012012012
012012051051051051012012012012012012012012012012012012012012012012012012012012051051051051012012012012012012012012012012012012012012012012012012
012012051051051051012012012012012012012012012012012012012012012012012012012012051051051051012012012012012012012012012012012012012012012012012012
