000000000000000000000000000000000000000000000000000000000000000000000000000000000000000000000000000000000000000000000000000000000000000000000000
000000000000000000000000000000000000000000000000000000000000000000000000000000000000000000000000000000000000000014014014014000000000013013000000
000000000000000000000000000000000000000000000014014000000000000000000000000000000000000000000000000000000000000014014014000000000000013013000000
000000000000000000000000000000000000000000000014014014014000000000000000000000000000000000000000000000000000000000000000000000000000000000000000
000000000000000000000000000000000000000000000000014000000000000000000000000000000000000000000000000000000000000000000000000000000000000000000000
000000000000000000000000000000000000000000000000000000000000000000000000000000000000000000000000000000000000000000000000000000000000000000000000
000000000000000014014014014000000000000000000000000000000000000000000000000000014014014000000000000000000000000000000000000000000000000033033033
000000000000000014014014014000000000000000000000000000000000000000000000014014014000000000000000000000000000000000000000000033033033033033033033
000000000000000000000014014000000000000000000000000000000000000000000014014014014000000000000000000000000000000000000000033033033033033033033033
000000000000000000000000000000000000000000000000000000000000000000000014014000000000000000000000000000000000000000000033033033033033033033033033
000000000000000000000000000000000000000000000000000000000000000000000000000000000000000000000000000000000000000000000033033033033033033033033033
000000000000000000000000000000000000000000000000000000000000000000000000000000000000000000000000000000000000000000033033033033033033033033033033
000000000000000000000000000000000000000000000000000000000000000000000000000000000000000000000000000000000000000000033033033033033033033033033033
000000000000000000000000000000000000000000014014014014014014000000000000000000000000000000000000000000000000000033033033033033033033033033033033
000000000000000000000000000000000000000014014014014014014014014000000000000000000000000000000000000000000000000033033033033033033033033033033033
000000000000000000000000000000000000000000000000000000000000000000000000000000000000000000000000000000000000033033033033033033033033033033033033
000000000000000000000000000000000000000000000000000000000000000000000000000000000000000000000000000000000033033033033033033033033033033033033033
000000000000000000000000000000000000000000000000000000000000000000000000000000000000000000000000000000000033033033033033033033033033033033033033
000000000000000000000000000000000000000000000000000000000000000000000000000000000000000000000000000000033033033033033033033033033033033033033033
000000000000000000000000000000000000000000000000000000000000000000000000000000000000000000000000000033033033033033033033033033033033033033033033
000000000000000000000000000000000000000000000000000000000000000000000033033033000000000000033033033033033033033033033033033033033033033033033033
000000000000000000000000000000000000000000000000000000000000000000033033033033033033033033033033033033033033033033033033033033033033033033033033
000000000000000014014000000000000000000000000000000000000000000033033033033033033033033033033033033033033033033033033033033033033033033033033033
000000000000014000000000000000000000000000000000000000000000000033033033033033033033033033033033033033033033033033033033033033033033033033033033
000000000000000000000000000000000000000000000000000000000000033033033033033033033033033033033033033033033033033033033033033033033033033033033033
000000000000000000000000000000000000000000000000000000000000033033033033033033033033033033033033033033033033033033033033033033033033033033033033
000000000000000000000000000000033033000000000000000000000033033033033033033033033033033033033033033033033033033033033033033033033033033033033033
000000000000000000000000000000033033033033000000000000000033033033033033033033033033033033033033033033033033033033033033033033033033033033033033
000000000000000000000000000033033033033033033000000000033033033033033033033033033033033033033033033033033033033033033033033033033033033033033033
000000000000000000000000000033033033033033033000000033033033033033033033033033033033033033033033033033033033033033033033033033033033033033033033
000000000000000000000000033033033033033033033033033033033033033033033033033033033033033033033033033033033033033033033033033033033033033033033033
000000000000000000000000033033033033033033033033033033033033033033033033033033033033033033033033033033033033033033033033033033033033033033033033
000000000000000000000033033033033033033033033033033033033033033033033033033033033033033033033033033033033033033033033033033033033033033033033033
033033000000000033033033033033033033033033033033033033033033033033033033033033033033033033033033033033033033033033033033033033033033033033033033
033033033033033033033033033033033033033033033033033033033033033033033033033033033033033033033033033033033033033033033033033033033033033033033033
033033033033033033033033033033033033033033033033033033033033033033033033033033033033033033033033033033033033033033033033033033033033033033033033
