000000000000000000000000000000000000000000000000000000000000000000000000000000000000000000000000000000000000000000000000000000000000000000000000000000000000000000000000000000000000000000000000
000000000000000000000000000000000000000000000000000000000000000000000000000000000000000000000000000000000000000000000000000000000000000000000000000000000000000028000000000000000000000000000000
000000000000000000000000000000000000000000000000000000000000000000000000000000000000000000000000000000000000000000000000000000000000000000000000000000000000000011000000000000000000000000000000
000000000000000000000000000000000000000000000000000000000000000000000000000000000000000000000000000000000000000000000000000000000000000000000000000000000000000011000000000000000000000000000000
000000000000000000000000000000000000000000000000000000000000000000000000000000000000000000000000000000000000000000000000000000000000000000000000000000000000021023022000000000000000000000000000
000000000000000000000000000000000000000000000000000000000000000000000000000000000000000000000000000000000000000000000000000000000000000000000000000000000000021027022000000000000000000000000000
000000000000000000000000000000000000000000000000000000000000000000000000000000000000000000000000000000000000000000000000000000000000000000000000000000000000021027022000000000000000000000000000
000000000000000000000000000000000000000000000000000000000000000000000017000000000000000000000000000000000000000000000000000000000000000000000000000000000000021023022000000000000000000000000000
000000000000000000000000000000000000000000000000000000000000000000000004018017000000000000000000000000000000000000000000000000000000000000000000000024011011021023022011011025000000000000000000
000000000000000000000000000000000000000000000000000000000000000000017004004004000000000000000018000000000000000000000000000000000000000000000000024011011011021023022011011011025000000000000000
000000000000000000000000000000000000000000000000000000000018017018004004004004017000000000000004000000000000000000000018000000000000017000000024011011011011021023022011011011011025000000000000
000000000000000000000000000000000000029000000000000000017004004004020015004004004017018000000004018017000018000018017004017018017017004000000011011011011011021015022011011011011011000000000000
000000000000000000000000000000000000030000000000000000004019004004004016004004019004004000000004004006017004018004020019004004004004004000000011011011011011021016022011011011011011000000000000
002002002002002002002002002002002002002001001001001001001001001001001001001001001001001001001001001001001001001001001001001001001001001001001001001001001001001001001001001001001001001001001001
002002002002002002002002002002002002002002002002002001001001001001001001001001001001001001001001001001001002001001001001001001001002002001001001001001001002001001001002001001001001001001001001
002002002002002002002002002002002002002002002002002002001001001001001001001001001001001001001001001002002002001001001002001002002002002002002002001001001002002002002002001001001001001002001002
002002002002002002002002002002002002002002002002002002001002001002002002001001002002002002002002002002002002001001001001001002002002002002002002002002002002002002002002002002002002002002002002
002002002002002002002002002002002002002002002002002002002002001001002002002002002002002002002002002002002002002002001002002002002002002002002002002002002002002002002002002002002002002002002002
