000000000000000000000000000000000000000000000000000000000000000000000000000000000000000000000000000000000000000000000000000033033033033033033033033033033033033033033033033033034034034034034034
000000000000000000000000000000000000000000000000000000000000000000000000000000000000000000000000000000000000000000000000000033033033033033033033033033033033033034034034034034034034034034034034
000000000000000000000000000000000000000000000000000000000000000000000000000000000000000000000000000000000000000000000000033033033033033034034034034034034034034034034034034034034034034034034034
000000000000000000000000000000000000000000000000000000000000000000000000000000000000000000000000000000000000000000000000033033034034034034034034034034034034034034034034034034034034034034034034
000000000000000000000000000000000000000000000000000000000000000000000000000000000000000000000000000000000000000000000000033033034034034034034034034034034034034034034034034034034034034034034034
000000000000000000000000000000000000000000000000000000000000000000000000000000000000000000000000000000000000000000000000034034034034034034034034034034034034034034034034034034034034034034034034
000000000000000000000000000033033033000000000000000000000000000000000000000000000000000000000000000000000000000000000000034034034034034034034034034034034034034034034034034034034034034034034034
000000000000000000000000033033033033000000000000000000000000000000000000000000000000000000000000000000000000000000000000034034034034034034034034034034034034034034034034034034034034034034034034
000000000000000000000033033033033033000000000000000000000000000000000000000000000000000000000000000000000000000000000034034034034034034034034034034034034034034034034034034034034034034034034034
000000000000000000000033033033033033000000000000000000000000000000000000000000000000000000000000000000000000000000000034034034034034034034034034034034034034034034034034034034034034034034034034
000000000000000000033033033033033033000000000000000000000000000000000000000000000000000000000000000000000000000000000034034034034034034034034034034034034034034034034034034034034034034034034034
033033033033033033033033033033033033000000000000000000000000000000000000000000000000000000000000000000000000000000000034034034034034034034034034034034034034034034034034034034034034034034034034
033033033033033033033033033033033033033033000000000000000000000000000000000000000000000000000000000000000000000000000034034034034034034034034034034034034034034034034034033033033033033033033033
033033033033033033033033033033033033033033033033033033033033033033033033033033033033033033033033033033033033033033033033033033033033033033033033033033033033033033033033033033033033033033033033
033033033033033033033033033033033033033033033033033033033033033033033033033033033033033033033033033033033033033033033033033033033033033033033033033033033033033033033033033033033033033033033033
033033033033033033033033033033033033033033033033033033033033033033033033033033033033033033033033033033033033033033033033033033033033033033033033033033033033033033033033033033033033033033033033
033033033033033033033033033033033033033033033033033033033033033033033033033033033033033033033033033033033033033033033033033033033033033033033033033033033033033033033033033033033033033033033033
033033033033033033033033033033033033033033033033033033033033033033033033033033033033033033033033033033033033033033033033033033033033033033033033033033033033033033033033033033033033033033033033
