000000000000000000000000000000000000000000000000000000000000000000000000000000000000000000000000000000000000000000000000000000000000000000000000000000000000000000000000000000000000000000000000
000000000000000000000000000000000000000000000000000000000000000000000000000000000000000000000000000000000000000000000000000000000000000000000000000000000000000000000000000000000000000000000000
000000000000000000000000000000000000000000000000000000000000000000000000000000000000000000000000000000000000000000000000000000000000000000000000000000000000000000000000000000000000000000000000
000000000000000000000000000000000000000000000000000000000000000000000000000000000000000000000000000000000000000000000000000000000000000000000000000000000000000000000000000000000000000000000000
000000000000000000000000000000000000000000000000000000000000000000000000000000000000000000000000000000000000000000000000000000000000000000000000000000000000000000000000000000000000000000000000
000000000000000000000000000000000000000000000000000000000000000000000000000000000000000000000000000000000000000000000000000000000000000000000000000000000000000000000000000000000000000000000000
000000000000000000000000000000000000000000000000000000000000000000000000000000000000000000000000000000000000000000000000000000000000000000000000000000000000000000000000000000000000000000000000
000000000000000000000000000000000000000000000000000000000000000000000000000000000000000000000000000000000000000000000000000000000000000000000000000000000000000000000000000000000000000000000000
000000000000000000000000000000000000000000000000000000000000000000000000000000000000000000000000000000000000000000000000000000000000000000000000000000000000000000000000000000000000000000000000
000000000000000000000000000000000000000000000000000000000000033033033000000000000000000000000000000000000000000000000000000000000000000000000000000000000000000000000000033033033033033033033033
000000000000000000000000000000000000000000000000000033033033033033033033033033033033033033033033033033033033033033033033033033033033033033033033033033033033033033033033033033033033033033033033
000000000000000000000000000000000000000000000034033033033033033033033033033033033033033033033033033033033033033033033033033033033033033033033033033033033033033033033033033033033033033033033033
000000000000000000000000000000000000034033033034034034034034034034034034034034034034033033033033033033033033033033033033033033033033033033033033033033033033033033033033033033033033033033033033
000000000000000000000000000000034034034034034034034034034034034034034034034034034034034034034034034034034033033033033033033033033033033033033033033033033033033033033033033033033033033033033033
000000000000000000000000034034034034034034034034034034034034034034034034034034034034034034034034034034034034034034034034034034034034034033033033033033033033033033033033033033033033033033033033
000000000000000000000000034033034034034034034034034034034034034034034034034034034034034034034034034034034034034034034034034034034034034034034034034034034034034034033033033033033033033033033033
000000000000000000000000034033034034034034034034034034034034034034034034034034034034034034034034034034034034034034034034034034034034034034034034034034034034034034034034034033033033033033033033
000000000000000000000000034033033033034034034034034034034034034034034034034034034034034034034034034034034034034034034034034034034034034034034034034034034034034034034034034034033033033033033033
000000000000000000000000034034034034034034034034034034034034034034034034034034034034034034034034034034034034034034034034034034034034034034034034034034034034034034034034034034034033033033033033
000000000000000000000034034034034034034034033033034034034034034034034034034034034034034034034034034034034034034034034034034034034034034034034034034034034034034034034034034034034033033033033033
000000000000000000000034034034034034034034034034034034034034034034034034034034034034034034034034034034034034034034034034034034034034034034034034034034034034034034034034034034034033033033033033
000000000000000000000034034034034034034034034034034034034034034034034034034034034034034034034034034034034034034034034034034034034034034034034034034034034034034034034034034034034034033033033033
000000000000000000000034034034033033034034034034034034034034034034034034034034034034034034034034034034034034034034034034034034034034034034034034034034034034034034034034034034034034033033033033
000000000000000000034034033033033033033033033033033033034034034034034034034034034034034034034034034034034034034034034034034034034034034034034034034034034034034034034034034034034034033033033033
000000000000000034034033033033033033033033033033033033033033033033033033033033033033033033034034034034034034034034034034034034034034034034034034034034034034034034034034034034034034034033033033
000000000000000034034033033033033033033033033033033033033033033033033033033033033033033033033033033033033033033033033034034034034034034034034034034034034034034034034034034034034034034033033033
000000000000000034034034034033033033033033033033033033033033033033033033033033033033033033033033033033033033033033033033033033034034034034034034034034034034034034034034034034034034034034033033
000000000000000034034034034034034034034034034034034033033033033033033033033033033033033033033033033033033033033033033033033033033033033033033033034034034034034034034034034034034034034034033033
000000000000034034034034034034034034034034034034034034034034034034034034034034033033033033033033033033033033033033033033033033033033033033033033034034034034034034034034034034034034034034033033
000000000000034034034034034034034034034034034034034034034034034034034034034034034034034034034034034034034034034034034034034034034034034034034034034034033033033034034034034034034034034034033033
000000000034034034034034034034034034034034034034034034034034034034034034034034034034034034034034034034034034034034034034034034034034034034034034034034034034034034034034034034034034034034033033
000000000034034034034034034034034034034034034034034034034034034034034034034034034034034034034034034034034034034034034034034034034034034034034034034034034034034034034033033034034034034033033033
000034034034034034034034034034034034034034034034034034034034034034034034034034034034034034034034034034034034034034034034034034034034034034034034034034034034034034034034034034034034034033033033
034034034034034034034034034034034034034034034034034034034034034034034034034034034034034034034034034034034034034034034034034034034034034034034034034034034034034034034034034034034034034033033033
034034034034034034034034034034034034034034034034034034034034034034034034034034034034034034034034034034034034034034034034034034034034034034034034034034034034034034034034034034034034033033033033
034034034034034034034033033033034034034034034034034034034034034034034034034034034034034034034034034034034034034034034034034034034034034034034034034034034034034034034034034034034034033033033033
034034034034034034033033033033033033033034034034034034034034034034034034034034034034034034034034034034034034034034034034034034034034034034034034034034034034034034034034034034034033033033033033
034034034034034033033033033033033033033033033033033034034034034034034034034034034034034034034034034034034034034034034034034034034034034034034034034034034034034034034034034034033033033033033033
034034034034034033033033033033033033033033033033033033034034034034034034034034034034034034034034034034034034034034034034034034034034034034034034034034034034034034034034033033033033033033033033
034034034034033033033033033033033033033033033033033033033033033033033033033033033034034034034034034034034034034034034034034034034034034034034034034034034034034034034034033033033033033033033033
034034034034033033033033033033033033033033033033033033033033033033033033033033033033033033033033033033033033034034034034034034034034034034034034034033033033033033033033033033033033033033033033
033033033033033033033033033033033033033033033033033033033033033033033033033033033033033033033033033033033033033033033033033033033033033033033033033033033033033033033033033033033033033033033033
033033033033033033033033033033033033033033033033033033033033033033033033033033033033033033033033033033033033033033033033033033033033033033033033033033033033033033033033033033033033033033033033
033033033033033033033033033033033033033033033033033033033033033033033033033033033033033033033033033033033033033033033033033033033033033033033033033033033033033033033033033033033033033033033033
