000000000000000000000000000000000000000000000000000000000000000000000000000033033033033033033033033033033033033033033033033033033033033033033033033033033033033033033033033033033033033033033033
000000000000000000000000000000000000000000000000000000000000000000000000000033033033033033033033033033033033033033033033033033033033033033033033033033033033033033033033033033033033033033033033
000000000000000000000000000000000000000000000000000000000000000000000000033033033033033033033033033033033033033033033033033033033033033033033033033033033033033033033033033033033033033033033033
000000000000000000000000000000000000000000000000000000000000000000000033033033033033033033033033033033033034034034034034034034034034034034034034034034034033033034034034034034034034034033033033
000000000000000000000000000000000000000000000000000000000000000000000033033033033033033033033033033033034034034034034034034034034034034034034034034034034034033034034034034034034034034034033033
000000000000000000000000000000000000000000000000000000000000000000033033033033033033033033033033033034034034034034034034034034034034034034034034034034034034033034034034034034034034034034034034
000000000000000000000000000000000000000000000000000000000000000033033033033033033033033033033034034034034034034034034034034034034034034034034034034034034034034034034034034034034034034034034034
000000000000000000000000000000000000000000000000000000000000000033033033033033033033033034034034034034034034034034034034034034034034034034034034034034034034034034034034034034034034034034034034
000000000000000000000000000000000000000000000000000000000000033033033033033033033034034034034034034034034034034034034034034034034034034034034034034034034034034034034034034034034034034034034034
000000000000000000000000000000000000000000000000000000033033033033033033033033033034034034034034034034034034034034034034034034034034034034034034034034034034034034034034034034034034034034034034
000000000000000000000000000000000000000000000000000033033033033033033033033033034034034034034034034034034034034034034034034034034034034033033033033034034034034034034034034034034034034033033033
000000000000000000000000000000000000000000000000033033033033033033033033033034034034034034034034034034034034034034034033033033034034034034034034033034034034034034034034034033033033033033033033
000000000000000000000000000000000000000000000000033033033033033033033034034034034034034034034034034034034034034034034034034034034034034034034034034034034033033033033034034034034034034033033033
000000000000000000000000000000000000000000000000033033033033033033034034034034034034034034034034034034034034034034034034034034034034034034034034034034034034034034034034034034034034034033033033
000000000000000000000000000000000000000000000000033033033033033033034034034034034034034034034034034034034033033034034034034034034034034034034034034034034034034034034034034034034034034033033033
000000000000000000000000000000000000000000000000033033033033033033034034034034034034034034034034034034034033033034034034034034034034034034034034034034034034034034034034034034034034034033033033
000000000000000000000000000000000000000000000000033033034034034034034034034034034034034034034034034034034033033034034034034034034034034034034034034034034034034034034034034034034034034033033033
000000000000000000000000000000000000000000000000033033034034034034034034034034034034034034034034034034034033033033033034034034034034034034034034034034034034034034034034034034034034034033033033
000000000000000000000000000000000000000000000000033033034034034034034034034034034034034034034034034034034034033033033033033033034034034034034034034034034034034034034034034034034034034033033033
000000000000000000000000000000000000000000000000033033033033033033033033034034034034034034034034034034034034034034034034034034034034034034034034034034034034034034034034034033033033033033033033
000000000000000000000000000000000000000000000000033033033033033033033033034034034034034034034034034034034034034034034034034034034034033033034034034034034034034034034034034034034034034033033033
000000000000000000000000000000000000000000000000033033033033033033033033033034034034034034034034034034034034034034034034034034034034034033033033033033034034034034034034034034034034034033033033
000000000000000000000000000000000000000000000000033033033033034034034034034034034034034034034034034034034034034034034034034034034034034034034034034034034034034034034034034034034034034033033033
000000000000000000000000000000000000000000000000033033033033034034034034034034033033034034034034034034034034034034034034034034034034034034034034034034034034034034034034034034034034034033033033
000000000000000000000000000000000000000000000000033033033033034034034034034034034033034034034034034034034034034034034034034034034034034034034034034034034034033033034034034034034034034033033033
000000000000000000000000000000000000000000000033033033033033034034034034034034034033034034033034034034034034034034034034034034034034034034034034034034034034033034034034034034034034034033033033
000000000000000000000000000000000000000000000033033033033034034034034034034034034033034034033033033034034034034034034034034034034034034034034034034034034034033034034034034034034034034033033033
000000000000000000000000000000000000000000000033033033033034034034034034034034034034034034034034034034034034034034034034034034034034034034034034034034034033033034034034034034034034034033033033
000000000000000000000000000000000000000000000033033033033034034034034034034034034034034034034034034034034033033034034034034034034034034034034034034034034034034034034034034034034034034033033033
000000000000000000000000000000000000000000000033033033034034034034034034034034034034034034034034034034034034033033034034034034034034034034034033033034034034034034034034034034034034034033033033
000000000000000000000000000000000000000000000033033033034034034034034034034034034034034034034034034034034034034034034034034034034034033033033033034034034034034034034034034034034034034033033033
000000000000000000000000000000000000000000033033033033034034034034034034034034034034034034034034034034034034034034034034033033034034034034034034034034034034034034034034034034034034033033033033
000000000000000000000000000000000000000000033033033033034034034034034034034034034034034034034034034034034034034034034034033034034034034034034034034034034034034034034034034034034034033033033033
000000000000000000000000000000000000000000033033033034034034034034034034034034034034034034034034034034034034034034034033033034034034034034034034034034034034034034034034034034034034033033033033
000000000000000000000000000000000000000000033033033034034034034034034034034034034034034034034034034034034034034034034034033034034034034034034034034034034034034034034034034034034034033033033033
000000000000000000000000000000000000000000033033034034034034034034034034034034034034034034034034034034034034034034034034033034034034034034034034034034034034034034034034034034034034033033033033
000000000000000000000000000000000000000000033033034034034034034034034034034034034034034034034034034034034034034033033033033034034034034034034034034034034034034034034034034034034034033033033033
000000000000000000000000000000000000000000033033034034034034034034034034034034034034034034034034034034034034034034034034034034034034034034034034034034034034034034034034034034034034033033033033
000000000000000000000000000000000000000000033033034034034034034034034034034034034034034034034034033033033034034034034034034034034034034034034034034034034034034034034034034034034034033033033033
000000000000000000000000000000000000000033033033034034034034034034034034034034034034034034034033033034034034034034034034034034034034034034034034034034034034034034034034034034034033033033033033
000000000000000000000000000000000000000033033034034034034034034034034034034034034034034034034034034034034034034034034034034034034034034034034034034034034034034034034034034034034033033033033033
000000000000000000000000000000000000000033034034034034034034034034034034034034034034033034034034034034034034034034034034034034034034034034034034034034034034034034034034034034034033033033033033
000000000000000000000000000000000000000034034034034034034034034034034034034034034033033034034034034034034034034034034034034034034034034034034034034034034034034033033033033033033033033033033033
000000000000000000000000000000000000000034034034034034034034034034034034034034034033033034034034034034034034034034034034034034034034034034033033033033033033033033033033033033033033033033033033
000000000000000000000000000000000000000034034034034034034034034034034034034034034033033033034034034034034034034034034034034034033033033033033033033033033033033033033033033033033033033033033033
000000000000000000000000000000000000000034034034034034034034034034034034034034033033033033034034034034034034034034034033033033033033033033033033033033033033033033033033033033033033033033033033
000000000000000000000000000033033033033033033033033033033033033033033033033033033033033033033033033033033033033033033033033033033033033033033033033033033033033033033033033033033033033033033033
000000000000000000033033033033033033033033033033033033033033033033033033033033033033033033033033033033033033033033033033033033033033033033033033033033033033033033033033033033033033033033033033
000000000000000000033033033033033033033033033033033033033033033033033033033033033033033033033033033033033033033033033033033033033033033033033033033033033033033033033033033033033033033033033033
000000000000033033033033033033033033033033033033033033033033033033033033033033033033033033033033033033033033033033033033033033033033033033033033033033033033033033033033033033033033033033033033
033033033033033033033033033033033033033033033033033033033033033033033033033033033033033033033033033033033033033033033033033033033033033033033033033033033033033033033033033033033033033033033033
033033033033033033033033033033033033033033033033033033033033033033033033033033033033033033033033033033033033033033033033033033033033033033033033033033033033033033033033033033033033033033033033
033033033033033033033033033033033033033033033033033033033033033033033033033033033033033033033033033033033033033033033033033033033033033033033033033033033033033033033033033033033033033033033033
033033033033033033033033033033033033033033033033033033033033033033033033033033033033033033033033033033033033033033033033033033033033033033033033033033033033033033033033033033033033033033033033
