000000000000000000000000000000000000000000000000000000000000000000000000000000000000000000000000000000000000000000000000000000000000000000000000000000000000000000000000000000000000000000000000000000000000000000000000000000000000000000000000000000000000000000000000000000000000000000000000
000000000000000000000000000000000000000000000000000000000000000000000000000000000000000000000000000000000000000000000000000000000000000000000000000000000000000000000000000000000000000000000000000000000000000000000000000000000000000000000000000000000000000000000000000000000000000000000000
000000000000000000000000000000000000000000000000000000000000000000000000000000000000000000000000000000000000000000000000000000000000000000000000000000000000000000000000000000000000000000000000000000000000000000000000000000000000000000000000000000000000000000000000000000000000000000000000
000000000000000000000000000000000000000000000000000000000000000000000000000000000000000000000000000000000000000000000000000000000000000000000000000000000000000000000000000000000000000000000000000000000000000000000000000000000000000000000000000000000000000000000000000000000000000000000000
000000000000000000000000000000000000000000000000000000000000000000000000000000000000000000000000000000000000000000000000000000000000000000000000000000000000000000000000000000000000000000000000000000000000000000000000000000000000000000000000000000000000000000000000000000000000000000000000
000000000000000000000000000000000000000000000000000000000000000000000000000000000000000000000000000000000000000000000000000000000000000000000000000000000000000000000000000000000000000000000000000000000000000000000000000000000000000000000000000000000000000000000000000000000000000000000000
000000000000000000000000000000000000000000000000000000000000000000000000000000000000000000000000000000000000000000000000000000000000000000000000000000000000000000000000000000000000000000000000000000000000000000000000000000000000000000000000000000000000000000000000000000000000000000000000
000000000000000000000000000000000000000000000000000000000000000000000000000000000000000000000000000000000000000000000000000000000000000000000000000000000000000000000000000000000000000000000000000000000000000000000000000000000000000000000000000000000000000000000000000000000000000000000000
000000000000000000000000000000000000000000000000000000000000000000000000000000000000000000000000000000000000000000000000000000000000000000000000000000000000000000000000000000000000000000000000000000000000000000000000000000000000000000000000000000000000000000000000000000000000000000000000
000000000000000000000000000000000000000000000000000000000000000000000000000000000000000000000000000000000000000000000000000000000000000000000000000000000000000000000000000000000000000000000000000000000000000000000000000000000000000000000000000000000000000000034034034034060033033033033033
000000000000000000000000000000000000000000000000000000000000000000000000000000000000000000000000000000000000000000000000000000000000000000000000000000000000000000000000000000000000000000000000000000000000000000000000000000000000000000000000000000000000000034034034034034060033033033033033
000000000000000000000000000000000000000000000000000000000000000000000000000000000000000000000000000000000000000000000000000000000000000000000000000000000000000000000000000000000000000000000000000000000000000000000000000000000000000000000000000000034034034034034034034033033033033033033033
000000000000000000000000000000000000000000000000000000000000000000000000000000000000000000000000000000000000000000000000000000000000000000000000000000000000000000000000000000000000000000000000000000000000000000000000000000000000000033033033033060034034034034034034034033033033033033033033
000000000000000000000000000000000000000000000000000000000000000000000000000000000000000000000000000000000000000000000000000000000000000000000000000000000000000000000000000000000000000000000000000000000000000000000000000000000000000033033033033033034034034034034034033033033033033033033033
000000000000000000000000000000000000000000000000000000000000000000000000000000000000000000000000000000000000000000000000000000000000000000000000000000000000000000000000000000000000000000000000000000000000000000000000000000000000033033033033033033034034034034034034033033033033033033033033
000000000000000000000000000000000000000000000000000000000000000000000000000000000000000000000000000000000000000000000000000000000000000000000000000000000000000000000000000000000000000000000000000000000000000000000000000000000033033033033033033033033034034034034034060033033033033033033033
000000000000000000000000000000000000000000000000000000000000000000000000000000000000000000000000000000000000000000000000000000000000000000000000000000000000000000000000000000000000000000000000000000000000000000000000000000033033033033033033033033034034034034034034033033033033033033033033
000000000000000000000000000000000000000000000000000000000000000000000000000000000000000000000000000000000000000000000000000000000000000000000000000000000000000000000000000000000000000000000000000000000000000000000000000000033033033033033033060034034034034034034034033033033033033033033033
000000000000000000000000000000000000000000000000000000000000000000000000000000000000000000000000000000000000000000000000000000000000000000000000000000000000000000000000000000000000000000000000000000000000000000000000033033033033033033033033033034034034034034034033033033033033033033033033
000000000000000000000000000000000000000000000000000000000000000000000000000000000000000000000000000000000000000000000000000000000000000000000000000000000000000000000000000000000000000000000000000000000000000000033033033033033033033033033033033034034034034034034033033033033033033033033033
000000000000000000000000000000000000000000000000000000000000000000000000000000000000000000000000000000000000000000000000000000000000000000000000000000000000000000000000000000000000000000000000000000000000000000060033033033033033033033033033033033034034034034034033033033033033033033033033
000000000000000000000000000000000000000000000000000000000000000000000000000000000000000000000000000000000000000000000000000000000000000000000000000000000000000000000000000000000000000000000000000000000000000000000034034034034034034034034034034034034034034034034033033033033033033033033033
000000000000000000000000000000000000000000000000000000000000000000000000000000000000000000000000000000000000000000000000000000000000000000000000000000000000000000000000000000000000000000000000000000000000000000000034034034034034034034034034034034034034034034033033033033033033033033033033
000000000000000000000000000000000000000000000000000000000000000000000000000000000000000000000000000000000000000000000000000000000000000000000000000000000000000000000000000000000000000000000000000000000000000000000034034034034034034034034034034034034034034034033033033033033033033033033033
000000000000000000000000000000000000000000000000000000000000000000000000000000000000000000000000000000000000000000000000000000000000000000000000000000000000000000000000000000000000000000000000000000000000000033033033033033033033033033033033033033033033033033033033033033033033033033033033
000000000000000000000000000000000000000000000000000000000000000000000000000000000000000000000000000000000000000000000000000000000000000000000000000000000000000000000000000000000000000000000000000000000000000033033033033033033033033033033033033033033033033033033033033033033033033033033033
000000000000000000000000000000000000000000000000000000000000000000000000000000000000000000000000000000000000000000000000000000000000000000000000000000000000000000000000000000000000000000000000000000000000000033033033033033033033033033033033033033033033033033033033033033033033033033033033
000000000000000000000000000000000000000000000000000000000000000000000000000000000000000000000000000000000000000000000000000000000000000000000000000000000000000000000000000000000000000000000000000000000000000033033033033033033033033033033033033033033033033033033033033033033033033033033033
000000000000000000000000000000000000000000000000000000000000000000000000000000000000000000000000000000000000000000000000000000000000000000000000000000000000000000000000000000000000000000000000000000000000000033033033033033033033033033033033033033033033033033033033033033033033033033033033
000000000000000000000000000000000000000000000000000000000000000000000000000000000000000000000000000000000000000000000000000000000000000000000000000000000000000033033033033033033033033033033033033033033033033033033033033033033033033033033033033033033033033033033033033033033033033033033033
000000000000000000000000000000000000000000000000000000000000000000000000000000000000000000000000000000000000000000000000000000000000033033033033000000033033033033033033033033033033033033033033033033033033033033033033033033033033033033033033033033033033033033033033033033033033033033033033
033033033000000000000000000000000000000000000000000000000000000000000000000000000000000000000000000000000000000000000000000000000033033033033034000000000000000000000033033033033033033033033033033033033033033033033033033033033033033033033033033033033033033033033033033033033033033033033033
033033033033033033000000000000000000000000000000000000000000000000000000000000000060060060000000000000000000000000000000000000000033033034034034000000000000000000000000033033033033033033033033033033033033033033033033033033033033033033033033033033033033033033033033033033033033033033033033
033033033033033033033033000000000000000000000000000000000000000000000000000000034034034034034000000000000000000000000000000060033033034034034000000000000000000000000000000033033033033033033033033033033033033033033033033033033033033033033033033033033033033033033033033033033033033033033033
033033033033033033033033000000000000000000000000000000000000000000000000000000034034034034034000000000000000000000000000000060033033034034034000000000000000000000000000000000033033033033033033033033033033033033033033033033033033033033033033033033033033033033033033033033033033033033033033
033033033033033033033033033000000000000000000000000000000000000000000000000000034034034034034000000000000000000000000000000033033033034034034000000000000000000000000000000000000033033033033033033033033033033033033033033033033033033033033033033033033033033033033033033033033033033033033033
033033033033033033033033033000000000000000000000000000000000000000000000000000033033033033033000000000000000000000000000033033034034034034034000000000000000000000000000000000000033033033033033033033033033033033033033033033033033033033033033033033033033033033033033033033033033033033033033
034034034034034033033033033000000000000000000000000000000000000000000000000000000033033033000000000000000000000000000033033034034034034034034000000000000000000000000000000000000033033033033033033033033033033033033033033033033033033033033033033033033033033033033033033033033033033033033033
034034034034034034034033033000000000000000000000000033033000000000000000000000000034034000000000000000000000000000000033034034034034034034034000000000000000000000000000000000000033033033033033033033033033033033033033033033033033033033033033033033033033033033033033033033033033033033033033
034034034034034034034033033000000000000000000060060060000000000000000000000000000034034000000000000000000000000000000000000000034034034034034000000000000000000000000000000000000033033033033033033033033033033033033033033033033033033033033033033033033033033033033033033033033033033033033033
034034034034034034034033033000000000000000034034034034000000000000000000000000000034034000000000000000000000000000000000000000000034034034000000000000000000000000000000000000033033033033033033033033033033033033033033033033033033033033033033033033033033033033033033033033033033033033033033
033033034034034034034033033033000000033034034034034034000000000000000000000000000034034000000000000000000000000000000000000000000034034034000000000000000000000000000000000000033033033033033033033033033033033033033033033033033033033033033033033033033033033033033033033033033033033033033033
033033033034034034034033033033033033033034034034034034000000000000000000000000000034034000000000000000000000000000000000000000000000034034000000000000000000000000000000000000033033033033033033033033033033033033033033033033033033033033033033033033033033033033033033033033033033033033033033
033033033034034034034034033033033033033033033033034034000000000000000000000000000034034000000000000000000000000000000000000000000000034034000000000000000000000000000000000000033033033033033033033033033033033033033033033033033033033033033033033033033033033033033033033033033033033033033033
033033033034034034034034033033033033033033033033033034000000000000000000000000000034034000000000000000000000000000000000000000000000034034000000000000000000000000000000000000033033033033033033033033033033033033033033033033033033033033033033033033033033033033033033033033033033033033033033
033033033033034034034034033033033033033033033033033034000000000000000000000000000034034000000000000000000000000000000000000000000000034034000000000000000000000000000000000000033033033033033033034034034034034034034034034034034034034034034034034034034034034034034034034033033033033033033033
033033033033034034034034034033033033033033033033033033000000000000000000000000000034034000000000000000000000000000000000000000000000034034000000000000000000000000000000000000000033033033034034034034034034034034034034034034034034034034034034034034034034034034034034034033033033033033033033
033033033033034034034034034034034034034034034034033033000000000000000000000000000034034000000000000000000000000000000000000000000000034034000000000000000000000000000000000000000000033034034034034034034034034034034034034034034034034034034034034034034034034034034034034033033033033033033033
033033033033033034034034034034034034034034034034034034000000000000000000000000000034034000000000000000000000000000000000000000000000034034000000000000000000000000000000000000000000034034034034034034034034034034034034034034034034034034034034034034034034034034034034034033033033033033033033
033033033033033034034034034034034034034034034034034034034000000000000000000000000034034034000000000000000000000000000000000000000000034034000000000000000000000000000000000000000000034034034034034034034034034034034034034034034034034034034034034034034034034034034034034033033033033033033033
033033033033033033033033033033033034034034034034034034034000000000000000000000000034034034000033033033033033033033033033033033033033033033033033033033033033033033033033033033033033033033033033033033033033033033033033033033033033033033033033033033033033033033033033033033033033033033033033
033033033033033033033033033033033033033033033033033033033033033033033033033033033033033033033033033033033033033033033033033033033033033033033033033033033033033033033033033033033033033033033033033033033033033033033033033033033033033033033033033033033033033033033033033033033033033033033033
033033033033033033033033033033033033033033033033033033033033033033033033033033033033033033033033033033033033033033033033033033033033033033033033033033033033033033033033033033033033033033033033033033033033033033033033033033033033033033033033033033033033033033033033033033033033033033033033
033033033033033033033033033033033033033033033033033033033033033033033033033033033033033033033033033033033033033033033033033033033033033033033033033033033033033033033033033033033033033033033033033033033033033033033033033033033033033033033033033033033033033033033033033033033033033033033033
