000000000000000000000000000000000000000000000000000000000000000000000000000000000000000000000000000000000000000000000000000000000000000000000000000000000000000000000000000000000000000000000000
000000000000000000000000000000000000000000000000000000000000000000000000000000000000000000000000000000000000000000000000000000000000000000000000000000000000000000000000000000000000000000000000
000000000000000000000000000000000000000000000000000000000000000000000000000000000000000000000000000000000000000000000000000000000000000000000000000000000000000000000000000000000000000000000000
000000000000000000000000000000000000000000000000000000000000000000000000000000000000000000000000000000000000000000000000000000000000000000000000000000000000000000000000000000000000000000000000
000000000000000000000000000000000000000000000000000000000000000000000000000000000000000000000000000000000000000000000000000000000000000000000000000000000000000000000000000000000000000000000000
000000000000000000000000000000000000000000000000000000000000000000000000000000000000000000000000000000000000000000000000000000000000000000000000000000000000000000000000000000000000000000000000
000000000000000000000000000000000000000000000000000000000000000000000000000000000000000000000000000000000000000000000000000000000000000000000000000000000000000000000000000000000000000000000000
000000000000000000000000000000000000000000000000000000000000000000000000000000000000000000000000000000000000000000000000000000000000000000000000000000000000000000000000000000000000000000000000
000000000000000000000000000000000000000000000000033033033000000000000000000000000033033033000000000000000000000000033033033000000000000000000000000033033033000000000000000000000000033033033000
000000000000000000000000000000000000000000000000060060060000000000000000000000000060060060000000000000000000000000060060060000000000000000000000000060060060000000000000000000000000060060060000
000000000000000000000000000000000000000000000000034034034000000000000000000000000034034034000000000000000000000000034034034000000000000000000000000034034034000000000000000000000000034034034000
000000000000000000000000000000000000000000000000034034034000000000000000000000000034034034000000000000000000000000034034034000000000000000000000000034034034000000000000000000000000034034034000
000000000000000000000000000000000000000000000000034034034000000000000000000000000034034034000000000000000000000000034034034000000000000000000000000034034034000000000000000000000000034034034000
000000000000000000000000000000000000000000000000033033033000000000000000000000000033033033000000000000000000000000033033033000000000000000000000000033033033000000000000000000000000033033033033
000000000000000000000000000000000000000000000000033033033000000000000000000000000033033033000000000000000000000000033033033000000000000000000000000033033033000000000000000000000000033033033033
000000000000000000000000000000000000000000000000034034034000000000000000000000000034034034000000000000000000000000034034034000000000000000000000000034034034000000000000000000000000034034034033
000000000000000000000000000000000000000000000000034034034000000000000000000000000034034034000000000000000000000000034034034000000000000000000000000034034034000000000000000000000000034034034033
000000000000000000000000000000000000000000000000034034034000000000000000000000000034034034000000000000000000000000034034034000000000000000000000000034034034000000000000000000000000034034034033
000000000000000000000000000000000000000000000000034034034000000000033000000000000034034034000000000000000000000000034034034000000000000000000000000034034034000000000000000000000000034034034033
000000000000000000000000000000000000000000000000034034034000000033033000000000000034034034000000000000000000000000034034034000000000000000000000000034034034000000000000000000000000034034034033
000000000000000000000000000000000000000000000000034034034034034033033034034034034034034034034034034034034034034034034034034034034034034034034034034034034034034034034034034034034034034034034033
000000000000000000000000000000000000000000000034034034034034033033033033034034034034034034034034034034034034034034034034034034034034034034034034034034034034034034034034034034034034034034034033
000000000000000000000000000000000000000000033033033033033033033033033033033033033033033033033033033033033033033033033033033033033033033033033033033033033033033033033033033033033033033033033033
000000000000000000000000000000000000033033033033033033033033033033033033033033033033033033033033033033033033033033033033033033033033033033033033033033033033033033033033033033033033033033033033
033033033033033033033033033033033033033033033033033033033033033033033033033033033033033033033033033033033033033033033033033033033033033033033033033033033033033033033033033033033033033033033033
033033033033033033033033033033033033033033033033033033033033033033033033033033033033033033033033033033033033033033033033033033033033033033033033033033033033033033033033033033033033033033033033
033033033033033033033033033033033033033033033033033033033033033033033033033033033033033033033033033033033033033033033033033033033033033033033033033033033033033033033033033033033033033033033033
