000000000000000000000000000000000000000000000000000000000000000000000000000000000000000000000000000000000000000000000000000000000033033033033033
000000000000000000000000000000000000000000000000000000000000000000000000000000000000000000000000000000000000000000000000000000000033033033033033
000000000000000000000000000000000000000000000000000000000000000000000000000000000000000000000000000000000000000000000000000000033033033033033033
000000000000000000000000000000000000000000000000000000000000000000000000000000000000000000000000000000000000000000000000000033033033033033033033
000000000000000000000000000000000000000000000000000000000000000000000000000000000000000000000000000000000000000000000000033033033033033033033033
000000000000000000000000000000000000000000000000000000000000000000000000000000000000000000000000000000000000000000000000033033033033033033033033
000000000000000000000000000000000000000000000000000000000000000000000000000000000000000000000000000000000000000000000033033033033033033033033033
000000000000000000000000000000000000000000000000000000000000000000000000000000000000000000000000000000000000000000033033033033033033033033033033
000000000000000000000000000000000000000000000000000000000000000000000000000000000000000000000000000000000000000000033033033033033033033033033033
000000000000000000000000000000000000000000000000000000000000000000000000000000000000000000000000000000000000000033033033033034034034034034034034
000000000000000000000000000000000000000000000000000000000000000000000000000000000000000000000000000000000000000033034034034034034034034034034034
000000000000000000000000000000000000000000000000000000000000000000000000000000000000000000000000000000000000000034034034034034034034034034034034
000000000000000000000000000000000000000000000000000000000000000000000000000000000000000000000000000000000000000000034034034034034034034034034034
000000000000000000000000000000000000000000000000000000000000000000000000000000000000000000000000000000000000000029000034034034034034034034034034
000000000000000000000000000000000000000000000000000000000000000000000000000000000000000000000000000000000000000030000034034034034034034034034034
000000000000000000000000000000000000000000000000000000000000000000000000000000000000000000000000000000000000060033033033033033033033033033033033
000000000000000000000000000000000000000000000000000000000000000000000000000000000000000000000000000000000000033033033033033033033033033033033033
000000000000000000000000000000000000000000000000000000000000000000000000000000000000000000000000000000000000033033033033033033033033033033033033
000000000000000000000000000000000000000000000000000000000000000000000000000000000000000000000000000000000033033033033033033033033033033033033033
000000000000000000000000000000000000000000000000000000000000000000000000000000000000000000000000000000000033033033033033033033033033033033033033
000000000000000000000000000000000000000000000000000000000000000000000000000000000000000000000000000000000033033033033033033033033033033033033033
000000000000000000000000000000000000000000000000000000000000000000000000000000000000000000000000000000000033033033033033033033033033033033033033
000000000000000000000000000000000000000000000000000000000000000000000000000000000000000000000000000000000033033033033033033033033033033033033033
000000000000000000000000000000000000000000000000000000000000000000000000000033033033033033033033033033033033033033033033033033033033033033033033
000000000000000000000000000000000000000000000000000000000000000000060033033033033033033033033033033033033033033033033033033033033033033033033033
000000000000000000000000000000000000000000000000000000000000000000033033033033033033033033033033033033033033033033033033033033033033033033033033
000000000000000000000000000000000000000000000000000000000000000000033033033033033033033033033033033033033033033033033033033033033033033033033033
000000000000000000000000000000000000000000000000000000000000000033033033033033033033033033033033033033033033033033033033033033033033033033033033
000000000000000000000000000000000000000000000000000000000000000033033033033033033033033033033033033033033033033033033033033033033033033033033033
000000000000000000000000000000000000000000000000000000000000000033033033033033033033033033033033033033033033033033033033033033033033033033033033
000000000000000000000000000000000000000000000000000000000000000033033033033033033033033033033033033033033033033033033033033033033033033033033033
033033033033033033033033033033033033033033033033033033033033033033033033033033033033033033033033033033033033033033033033033033033033033033033033
033033033033033033033033033033033033033033033033033033033033033033033033033033033033033033033033033033033033033033033033033033033033033033033033
033033033033033033033033033033033033033033033033033033033033033033033033033033033033033033033033033033033033033033033033033033033033033033033033
033033033033033033033033033033033033033033033033033033033033033033033033033033033033033033033033033033033033033033033033033033033033033033033033
033033033033033033033033033033033033033033033033033033033033033033033033033033033033033033033033033033033033033033033033033033033033033033033033
