008008008008008008008008008008008008008008008008008008008008008008008008008008008008008008008008008008008008008008008008008008008008008008008008008008008008008008008008008008008008008008008008
008008008008008008008008008008008008008008008008008008008008008008008008008008008008008008008008008008008008008008008008008008008008008008008008008008008008008008008008008008008008008008008008
008008008008008008008008008008008008008008008008008008008008008008008008008008008008008008008008008008008008008008008008008008008008008008008008008008008008008008008008008008008008008008008008
008008008008008008008008008008008008008008008008008008008008008008008008008008008008008008008008008008008008008008008008008008008008008008008008008008008008008008008008008008008008008008008008
008008008008008008008008008008008008008008008008008008008008008008008008008008008008008008008008008008008008008008008008008008008008008008008008008008008008008008008008008008008008008008008008
008008008008008008008008008008008008008008008008008008008008008008008008008008008008008008008008008008008057037037008008008008008008008008008008008056004004008008008008008008008008008008008008
058058008008008008008008008008008008008008008008008008008008008008058037037037057058008008008008021023023023021022023021022023021022023023021022023023021022023021022023021022023023022032032032
058058004056004008008008008008057058037037037004004008008008008057058037037037057058056008004004021023023023021022023021022023021022023023021022023023021022023021022023021022023023022032032032
058058004004004004057056057057057058037037037004004004008008057057058037037037057058056056004004021023023023021022023021022023021022023023021022023023021022023021022023021022023023022032032032
058058058056004004057057057057058058037037037004004056056058057057058037037037057058056056004004021023023023021022023021022023021022023023021022023023021022023021022023021022023023022032032032
058058058056004004058056057057058058037037037004004056056058057057058037037037057058056056004004021023023023021022023021022023021022023023021022023023021022023021022023021022023023022032032032
058058056056004004058056057057058037037037004004004056056058057057058037037037057056056056004004021023023023021022023021022023021022023023015015023023021022023021022023021022023023022032032032
058058056004004004058056057057058037037037004004004056056057057057058037037037037056056004004004021023023023021022023021022023021022023023016016023023021022023021022023021022023023022032032032
002002002002002002002002002002002002002002002002002002002002002002002002002002002002002002002002002002002002002002002002002002002002002002002002002002002002002002002002002002002002002002002002
002002002002002002002002002002002002002002002002002002002002002002002002002002002002002002002002002002002002002002002002002002002002002002002002002002002002002002002002002002002002002002002002
002002002002002002002002002002002002002002002002002002002002002002002002002002002002002002002002002002002002002002002002002002002002002002002002002002002002002002002002002002002002002002002002
002002002002002002002002002002002002002002002002002002002002002002002002002002002002002002002002002002002002002002002002002002002002002002002002002002002002002002002002002002002002002002002002
002002002002002002002002002002002002002002002002002002002002002002002002002002002002002002002002002002002002002002002002002002002002002002002002002002002002002002002002002002002002002002002002
