008008008008008008008008008008008008008008008008008008008008008008008008008008008008008008008008008008008008008008008008008008008008
008008008008008008008008008008008008008008008008008008008008008008008008008008008008008008008008008008008008008008008008008008008008
008008008008008008008008008008008008008008008008008008008008008008008008008008008008008008008008008008008008008008008008008008008008
008008008008008008008008008008008008008008008008008008008008008008008008008008008008008008008008008008008008008008008008008008008008
008008008008008008008008008008008008008008008008008008008008008008008008008008008008008008008008008008008008008008008008008008008008
008008008008008008008008008008008008008008008008008008008008008008008008008008008008008008008008008008008057037037008008008008008008
032032032032032032032032032032032032032032032032032032032032032032032032032032032032032051051051051051051051051051051051051051051051
032032032032032032032032032032032032032032032032032032032032032032032032032032032032032051051051051051051051051051051051051051051051
032032032032032032032032032032032032032032032032032032032032032032032032032032032032032051051051051051051051051051051051051051051051
032032032032032032032032032032032032032032032032032032032032032032032032032032032032032032032032032032032032032032032032032032032032
032032032032032032032032032032032032032032032032032032032032032032032032032032032032032032032032032032032032032032032032032032032032
032032032032032032032032032032032032032032032032032032032032032032032032032032032032032032032032032032032032032032032032032032032032
032032032032032032032032032032032032032032032032032032032032032032032032032032032032032032032032032032032032032032032032032032032032
002002002002002002002002002002002002002002002002002002002002002002002002002002002002002002002002002002002002002002002002002002002002
002002002002002002002002002002002002002002002002002002002002002002002002002002002002002002002002002002002002002002002002002002002002
002002002002002002002002002002002002002002002002002002002002002002002002002002002002002002002002002002002002002002002002002002002002
002002002002002002002002002002002002002002002002002002002002002002002002002002002002002002002002002002002002002002002002002002002002
002002002002002002002002002002002002002002002002002002002002002002002002002002002002002002002002002002002002002002002002002002002002
