051051051051051051051051051051051051051051051051051051051051051051051051051051051051051051051051051051051051051051051051051051051051051051051051
051051051051051051051051051051051051051051051051051051051051051051051051051051051051051051051051051051051051051051051051051051051051051051051051
051051051051051051051051051051051051051051051051051051051051051051051051051051051051051051051051051051051051051051051051051051051051051051051051
051051051051051051051051051051051051051051051051051051051051051051051051051051051051051051051051051051051051051051051051051051051051051051051051
051051051051051051051051051051051051051051051051051051051051051051051051051051051051051051051051051051051051051051051051051051051051051051051051
051051051051051051051051051051051051051051051051051051051051051051051051051051051051051051051051051051051051051051051051051051051051051051051051
051051051051051051051051051051051051051051051051051051051051051051051051051051051051051051051051051051051051051051051051051051051051051051051051
051051051051051051051051051051051051051051051051051051051051051051051051051051051051051051051051051051051051051051051051051051051051051051051051
051051051051051061061061061051051051051051051051061061061051051051051051051051051061061061051051051051051051061061061051051051051061061061051051
032032032032032032032032032032032032032032032032032032032032032032032032032032032032032032032032032032032032032032032032032032032032032032011011
032032032032032032032032032032032032032032032032032032032032032032032032032032032032032032032032032032032032032032032032032032032032032032011051
032032032032032032032032032032032032032032032032032032032032032032032032032032032032032032032032032032032032032032032032032032032032032032051051
032032032032032032032032032032032032032032032032032032032032032032032032032032032032032032032032032032032032032032032032032032032032032032051051
032032032032032032032032032032032032032032032032032032032032032032032032032032032032032032032032032032032032032032032032032032032032032032051051
051051051051051051051032032032032032032032032051051051051051032032032032032032032032032032032032032032032032032032032032032032032032032032051051
051051051051051051051032032032032032032032032051032032032051032032032032032032051051051051051032032032032032032032032032032032032032032032051051
051051051051051051051032032032032032032032032032032032032032032032032032032032051032032032051032032032032032032032032032032032032032032051051051
051051051051051051051032032032032032032032032032032032032032032032032032032032032032032032032032032032032051051051051051032032032032032032061051
051051051051051051051032032032032032032032032032032032032032032032032032032032032032032032032032032032032051032032032051032032032032032032061051
051051051051051051051032032032032032032032032032032032032032032032032032032032032032032032032032032032032032032032032032032032032032032032061051
051051051051051051051032032032032032032032032032032032032032032032032032032032032032032032032032032032032032032032032032032032032032032032051051
051051051051051051051032032032032032032032032032032032032032032032032032032032032032032032032032032032032032032032032032032032032032032032051051
051051051051051051051032032032032032032032032032032032032032032032032032032032032032032032032032032032032032032032032032032032032032051051051051
051051051051051051051032032032032032032032032032032032032032032032032032032032032032032032032032032032032032032032032032032032032032032032032032
051051051051051051051032032032032032032032032032032032032032032032032032032032032032032032032032032032032032032032032032032032032032032032032032
051051051051051051051032032032032032032032032032032032032032032032032032032032032032032032032032032032032032032032032032032032032032032032032032
051051051051051051051032032032032032032032032032032032032032032032032032032032032032032032032032032032032032032032032032032032032032032032032032
051051051051051051051032032032032032032032032032032032032032032032032032032032032032032032032032032032032032051051051051051051051051051051051051
051051051051051051051032032032032032032032032032032032032032032032032032032032032032032032032032032032032032051051051051051051051051051051051051
051051051051032032032032032032032032032032032032032032032032032032032032032032032032032032032032032032032032032032032051051051051051051051051051
051051051051051051051051051051051051051051051051051051051051051051051051051051051051051051051051051051051051011051051051051051051051051051051051
051051051051051051051051051051051051051051051051051051051051051051051051051051051051051051051051051051051051051051051051051051051051051051051051
051051051051051051051051051051051051051051051051051051051051051051051051051051051051051051051051051051051051051051051051051051051051051051051051
051051051051051051051051051051051051051051051051051051051051051051051051051051051051051051051051051051051051051051051051051051051051051051051051
051051051051051051051051051051051051051051051051051051051051051051051051051051051051051051051051051051051051051051051051051051051051051051051051
051051051051051051051051051051051051051051051051051051051051051051051051051051051051051051051051051051051051051051051051051051051051051051051051
051051051051051051051051051051051051051051051051051051051051051051051051051051051051051051051051051051051051051051051051051051051051051051051051
051051051051051051051051051051051051051051051051051051051051051051051051051051051051051051051051051051051051051051051051051051051051051051051051
