051051051051051051051051051051051051051051051051051051051051051051051051051051051051051051051051051051051051051051051051051051051051051051051051051051051051051051051051051051051051051051051051
051051051051051051051051051051051051051051051051051051051051051051051051051051051051051051051051051051051051051051051051051051051051051051051051051051051051051051051051051051051051051051051051
051051051051051051051051051051051051051051051051051051051051051051051051051051051051051051051051051051051051051051051051051051051051051051051051051051051051051051051051051051051051051051051051
051051051051051051051051051051051051051051051051051051051051051051051051051051051051051051051051051051051051051051051051051051051051051051051051051051051051051051051051051051051051051051051051
051051051051051051051051051051051051051051051051051051051051051051051051051051051051051051051051051051051051051051051051051051051051051051051051051051051051051051051051051051051051051051051051
051051032032032032032032032011032032032032032032032032032032032032032032032032032032032032032032032032032032032032032032032032032032032032032032032032032032032032032032032032032032032032032032
051051051051051051051051051051032032032032032032032032032032032032032032032032032032032032032032032032032032032032032032032032032032032032032032032032032032032032032032032032032032032032032032
051051032032032032032032032011032032032032032032032032032032032032032032032032032032032032032032032032032032032032032032032032032032032032032032032032032032032032032032032032032032032032032032
051051051051051051051051051051032032032032032032032032032032032032032051051051032032032032032032051051051032032032032032032032051051051032032032032032032051051051032032032032032032032032032032
051051032032032032032032032011032032032032032032032032032032032032032032032032032032032032032032032032032032032032032032032032032032032032032032032032032032032032032032032032032032032032032032
051051051051051051051051051051032032032032032032032032032032032051051051051051051051032032051051051051051051051032032032051051051051051051051032032051051051051051051051051051051051051051051051
051051051051051051051051051051032032032032032032032032032032032051051051051051051051032032051051051051051051051032032032051051051051051051051032032051051051051051051051051051051051051051051051
051051051051051051051051051051032032032032032032032032032051051051051051051051051051032032051051051051051051051032032032051051051051051051051032032051051051051051051051051051051051051051051051
051051051051051051051051051051032032032051051051032032032032032051051051051051051051051051051051051051051051051051051051051051051051051051051051051051051051051051051051051051051051051051051051
051051051051051051051051051051032032032051051051032032032032032051051051051051051051051051051051051051051051051051051051051051051051051051051051051051051051051051051051051051051051051051051051
051051051051051051051051051051032032032051051051032032032032032051051051051051051051051051051051051051051051051051051051051051051051051051051051051051051051051051051051051051051051051051051051
051051051051051051051051051051032032032051051051051051032032032032032051051051051051051051051051051051051051051051051051051051051051051051051051051051051051051051051051051051051051051051051051
051051051051051051051051051051032032032051051051051051032032032032032051051051051051051051051051051051051051051051051051051051051051051051051051051051051051051051051051051051051051051051051051
051051051051051051051051051051032032032051051051051051032032032032032051051051051051051051051051051051051051051051051051051051051051051051051051051051051051051051051051051051051051051051051051
051051051051051051051051051051032032032051051051051051051051032032032032032051011051051051051051051051051051051051051051051051051051051051051051051051051051051051051051051051051051051051051051
051051051051051051051051051051032032032051051051051051051051032032032032032051011011011011011011011011011011011011011011011011011011011011011011011011011011051051051051051051051051051051051051
051051051051051051051051051051032032032051051051051051051051032032032032032051051051051051051051051051051051051051051051051051051051051051051051051051051051051051051051051051051051051051051051
051051051051051051051051051051032032032051051051051051051051051051032032032032032032032032032032032032032032032032032032032032032032032032032032032032032032051051051051051051051051051051051051
032032032032032032032032032032032032032051051051051051051051051051032032032032032032032032032032032032032032032032032032032032032032032032032032032032032032011032032032032032032032032032051051
032032032032032032032032032032032032032051051051051051051051051051032032032032051032032032032032032051032032032032032032051032032032032032032032032032032032051051051051051051051051051051051051
032032032032032032032032032032032032032051051051051051051051051051051051051051051051051051051051051051051051051051051051051051051051051051051032032032032032051051051051051051051051051051051051
032032032032032032032032032032032032032051051051051051051051051051051051051051051051051051051051051051051051051051051051051051051051051051051051032032032032051051051051051051051051051051051051
051051051051051051051051051051032032032032032032032032032032032032032032032032032032032032032032032032032032032032032032032032032032032032032032032032032032051051051051051051051051051051051051
051051051051051051051051051051032032032032032032032032032032032032032032032032032032032032032032032032032032032032032032032032032032032032032032032032032032051051051051051051051051051051051051
051051032032032032032032032011032032032032032032032032032032032032032032032032032032032032032032032032032032032032032032032032032032032032032032032032051051051051051051051051051051051051051051
051051051051051051051051051051051032032032032032032032032032032032032032032032032032032032032032032032032032032032032032032032032032032032032032032032051051051051051051051051051051051051051051
051051032032032032032032032011011032032032032032032032032032032032032032032032032032032032032032032032032032032032032032032032032032032032032032032032051051051051051051051051051051051051051051
051051051051051051051051051051051051051051051051051051051051051051051051051051051051051051051051051051051051051051051051051051051051051051051051051051051051051051051051051051051051051051051051
051051051051051051051051051051051051051051051051051051051051051051051051051051051051051051051051051051051051051051051051051051051051051051051051051051051051051051051051051051051051051051051051
051051051051051051051051051051051051051051051051051051051051051051051051051051051051051051051051051051051051051051051051051051051051051051051051051051051051051051051051051051051051051051051051
051051051051051051051051051051051051051051051051051051051051051051051051051051051051051051051051051051051051051051051051051051051051051051051051051051051051051051051051051051051051051051051051
