051051051051051051051051051051051051051051051051051051051051051051051051051051051051051051051051051051051051051051051051051051051051051051051051051051051051051051051051051051051051051051051051
051051051051051051051051051051051051051051051051051051051051051051051051051051051051051051051051051051051051051051051051051051051051051051051051051051051051051051051051051051051051051051051051
051051051051051051051051051051051051051051051051051051051051051051051051051051051051051051051051051051051051051051051051051051051051051051051051051051051051051051051051051051051051051051051051
051051051051051051051051051051051051061061061061051051051051051051051051061061061061051051051051051051051051051051061061051051051051051051051051051051061061051051051051051051051051061051051051
032032032032032032032032032032032032032032032032032032032032032032032032032032032032032032032032032032032032032032032032032032032032032032032032032032032032032032032032032032032032032032051051
032032032032032032032032032032032032032032032032032032032032032032032032032032032032032032032032032032032032032032032032032032032032032032032032032032032032032032032032032032032032032032051051
032032032032032032032032032032032032032032032032032032032032032032032032032032032032032032032032032032032032032032032032032032032032032032032032032032032032032032032032032032032032032032051051
032032032032032032032032032032032032032032032032032032032032032032032032032032032032032032032032032032032032032032032032032032032032032032032032032032032032032032032032032032032032032032051051
032032032032032032032032032032032032032032032032032032032032032032032032032032032032032032032032032032032032032032032032032032032032032032032032032032032032032032032032032032032032032032032032
032032032032032032032032032032032032032032032032032032032032032032032032032032032032032032032032032032032032032032032032032032032032032032032032032032032032032032032032032032032032032032032032
051051051051051032032032032032032032051051051051032032032032032032032032051051051051032032032032032032032032032051051051051032032032032032032032032051051051051032032032032032032051051051051051
051051051051051032032032032032032032032032032032032032032032032032032032032032032032032032032032032032032032032032032032032032032032032032032032032032032032032032032032032032032032051051051051
051051051051051051032032032032032032032032032032032032032032032032032032032032032032032032032032032032032032032032032032032032032032032032032032032032032032032032032032032032032032051051051051
051051051051051051032032032032032032032032032032032032032032032032032032032032032032032032032032032032032032032032032032032032032032032032032032032032032032032032032032032032032032051051051051
051051051051051051051032032032032032032032032032032032032032032032032032032032032032032032032032032032032032032032032032032032032032032032032032032032032032032032032032032032032032051051051051
051051051051051051051032032032032032032032032032032032032032032032032032032032032032032032032032032032032032032032032032032032032032032032032032032032032032032032032032032032032032051051051051
051051051051051051051051032032032032032032032032032032032032032032032032032032032032032032032032032032032032032032032032032032032032032032032032032032032032032032032032032032032032051051051051
051051051051051051051051032032032032032032032032032032032032032032032032032032032032032032032032032032032032032032032032032032032032032032032032032032032032032032032032032032032032051051051051
051051051051051051051051051032032032032032032032032032032032032032032032032032032032032032032032032032032032032032032032032032032032032032032032032032032032032032032032032032032032051051051051
051051051051051051051051051032032032032032032032032032032032032032032032032032032032032032032032032032032032032032032032032032032032032032032032032032032032032032032032032032032032051051051051
051051051051051051051051051051032032032032032032032032032032032032032032032032032032032032032032032032032032032032032032032032032032032032032032032032032032032032032032032032032032051051051051
051051051051051051051051051051032032032032032032032032032032032032032032032032032032032032032032032032032032032032032032032032032032032032032032032032032032032032032032032032032032051051051051
051051051051051051051051051051051051051051051051051051051051051051051051051051051051051051051051051051051051051051051051051051051051051051051051051051051051051051051051032032032032051051051051
051051051051051051051051051051051051051051051051051051051051051051051051051051051051051051051051051051051051051051051051051051051051051051051051051051051051051051051051032032032032051051051051
051051051051051051051051051051051051051051051051051051051051051051051051051051051051051051051051051051051051051051051051051051051051051051051051051051051051051051051051051051032032051051051051
051051051051051051051051051051051051051051051051051051051051051051051051051051051051051051051051051051051051051051051051051051051051051051051051051051051051051051051051051051007007051051051051
051051051051051051051051051051051051051051051051051051051051051051051051051051051051051051051051051051051051051051051051051051051051051051051051051051051051051051051051051051051051051051051051
