051051051051051051051051051051051051051051051051051051051051051051051051051051051051051051051051051051051051051051051051051051051051051051051051051051051051051051051051051051051051051051051051
051051051051051051051051051051051051051051051051051051051051051051051051051051051051051051051051051051051051051051051051051051051051051051051051051051051051051051051051051051051051051051051051
051051051051051051051051051051051051051051051051051051051051051051051051051051051051051051051051051051051051051051051051051051051051051051051051051051051051051051051051051051051051051051051051
051051051051051051051051051051051051051051051051051051051051051051051051051051051051051051051051051051051051051051051051051051051051051051051051051051051051051051051051051051051051007007051051
051051051051023023023023051051051051051051051051051051051051051051051051051051051051051051051051051051051051051051051051051032032032032032032032032032032032032032032032032032032032007007051051
051051051051023023023023051051051051051051051051051051051023023023023023023023023023023023023023023023023023023023023051051032032032032032032032032032032032032032032032032032032032007007051051
051051051051023023023023023051051051051051051051051051051023023023023023023023023023023023023023023023023023023023023023023064032032032032032032032032032032032032032032032032032051051051051051
051051051051023023023023023051051051051051051051051051051023023023023023023023023023023023023023023023023023023023023023023064032032032032032032032032032032032032032032032032032051051051051051
051051051051023023023023023023051051051051051051051051051023023023023023023023023023023023023023023023051051051051051051051051051032032032032032032032032032032032032032032051051051051051051051
051051051051051023023023023023051051051051051051051051051023023023023023023051051051051051051051051051051051051051051051051051051032032032032032032032032032032032032032032051051051051051051051
051051051051051023023023023023023051051051051051051051051023023023023051051051051051051051051051051051023023023023023023023051051051051051051051051051051051051051051051051051051051051051051051
051051051051051051023023023023023051051051051051051051051023023023023051051023023023023023023023023023023023023023023023023051051051051051051051051051051051051051051051023023023023051051051051
051051051051051051023023023023023023051051051051051051051023023023051051023023023023023023023023023023023023023023023023023023023023051051051051051051051051051051051051023023023023051051051051
051051051051051051051023023023023023051051051051051051051023023023051051023023023023023023023023023023023023023023023023023023023023051051051051051051051051051051051023023023023023051051051051
051051051051051051051023023023023023023023051051051051051023023023051023023023023023023023023023023023023023051051051023023023023023051051051051051051051051051051051023023023023023051051051051
051051051051051051051051023023023023023023023023023051051064064051051023023023023023023023023023023023023023051051051023023023023023051051051051051051051051051051023023023023023051051051051051
051051051051051051051051023023023023023023023023023023064023023064023023023023023023023023023023023023023051051051051051023023023023051051051051051051051051051051023023023023023051051051051051
051051051051051051051051051051023023023023023023023023064023023064023023023023023023023023023023023023023051051051051051023023023023051051051051051051051051051023023023023023051051051051051051
051051051051051051051051051051051051051051051051051051051051051051051051051051051051051051051051051051051051051051051051051023023023051051051051051051051051051023023023023023051051051051051051
051051051051032032032032051051051051051051051051051051051051051051051051051051051051051051051051051051051051051051051051051023023023051051051051051051051051023023023023023051051051051051051051
051051051051032032032032051051023023023023023023023023023023023023023023023023023023023023023023023023023023023023023023051051064064051051051051051051051051023023023023023051051051051051051051
051051051051032032032064023023023023023023023023023023023023023023023023023023023023023023023023023023023023023023023023023064023023064023023023023023023023023023023023051051051051051051051051
051051051051032032032064023023023023023023023023023023023023023023023023023023023023023023023023023023023023023023023023023064023023064023023023023023023023023023023023051051051051051051051051
051051051051051051051051051051051051051051051051051051051051051051051051051051051051051051051051051051051051051051051051051051051051051051051051051051051051051051051051051051051051051051051051
051051051051051051051051051051051051051051051051051051051051051051051051051051051051051051051051051051051051051051051051051051051051051051051051051051051051051051051051051051051051051051051051
051051051051051051051051051051051051051051051051051051051051051051051051051051051051051051051051051051051051051051051051051051051051051051051051051051051051051051051051051051051051051051051051
051051051051051051051051051051051051051051051051051051051051051051051051051051051051051051051051051051051051051051051051051051051051051051051051051051051051051051051051051051051051051051051051
