051051051051051051051051051051051051051051051051051051051051051051051051051051051051051051051051051051051051051051051051051051051051051051051051
051051051051051051051051051051051051051051051051051051051051051051051051051051051051051051051051051051051051051051051051051051051051051051051051
051051051051051051051051051051051051051051051051051051051051051051051051051051051051051051051051051051051051051051051051051051051051051051051051
051051051051051051051051051051051051051051051051051051051051051051051051051051051051051051051051051051051051051051051051051051051051051051051051
051051051051051051051051051051051051051051051051051051051051051051051051051051051051051051051051051051051051051051051051051051051051051051051051
051051051051032032032032032032032032032032032032032032032032032032032032032032032032032032032032032032032032032032032032032032032032051051051051
051051051051032032032032032032032032032032032032032032032032032032032032032032032032032032032032032032032032032032032032032032032032051051051051
032032032032032032032032032032032032032032032032032032032032032032032032032032032032032032032032032032032032032032032032032032032032051051051051
032032032032032032032032032032032032032032032032032032032032032032032032032032032032032032032032032032032032032032032032032032007007051051051051
032032032032032032032032032032032032032032032032032032032032032032032032032032032032032032032032032032032032032032032032032032007007051051051051
032032032032032032032032032032032032032032032032032032032032032032032032032032032032032032032032032032032032032032032032032032007007051051051051
051051051051051051051051051051051051051051051051051051051051051051051051051051051051051051051051051051051051051051051051051051051051051051051051
051051051051051051051051051051051051051051051051051051051051051051051051051051051051051051051051051051051051051051051051051051051051051051051051
051051051051051051051051051051051051051051051051051051051051051051051051051051051051051051051051051051051051051051051051051051051051051051051051
051051051051051051051051051051051051051051051051051051051051051051051051051051051051051051051051051051051051051051051051051051051051051051051051
065065065065065065065065065065065065065065065065065065065065065065065065065065065065065065065065065065065065065065065065065065065065065065065065
065065065065065065065065065065065065065065065065065065065065065065065065065065065065065065065065065065065065065065065065065065065065065065065065
065065065065064064064064064064064064064064064064064064064064064064064064064064064064064064064064064064064064064064064064064064064064065065065065
065065065065064064064064064064064064064064064064064064064064064064064064064064064064064064064064064064064064064064064064064064064064065065065065
065065065065064064064064064064064064064064064064064064064064064064064064064064064064064064064064064064064064064064064064064064064064064064064064
065065065065007007064064064064064064064064064064064064064064064064064064064064064064064064064064064064064064064064064064064064064064064064064064
065065065065007007064064064064064064064064064064064064064064064064064064064064064064064064064064064064064064064064064064064064064064064064064064
065065065065007007064064064064064064064064064064064064064064064064064064064064064064064064064064064064064064064064064064064064064064064064064064
065065065065065065065065065065065065065065065065065065065065065065065065065065065065065065065065065065065065065065065065065065065065065065065065
065065065065065065065065065065065065065065065065065065065065065065065065065065065065065065065065065065065065065065065065065065065065065065065065
065065065065065065065065065065065065065065065065065065065065065065065065065065065065065065065065065065065065065065065065065065065065065065065065
065065065065065065065065065065065065065065065065065065065065065065065065065065065065065065065065065065065065065065065065065065065065065065065065
