065065065065065065065065065065065065065065065065065065065065065065065065065065065065065065065065065065065065065065065065065065065065065065065065
065065065065065065065065065065065065065065065065065065065065065065065065065065065065065065065065065065065065065065065065065065065065065065065065
065065065065065065065065065065065065065065065065065065065065065065065065065065065065065065065065065065065065065065065065065065065065065065065065
065065065065065065065065065065065065065065065065065065065065065065065065065065065065065065065065065065065065065065065065065065065065065065065065
065065065065065065065065065065065065065065065065065065065065065065065065065065065065065065065065065065065065065065065065065065065065065065065065
065065064064064064064064064064064064064064064064064064064064064064064064064064065064064065064064065064064065064064065064064065065065065065065065
065065007007064064064064064064064064064064064064064064064064064064064064064064064064064065064064064064064065064064064064064065065065065065065065
065065007007064064064064064064064064064064064064064064064064064064064064064064064064064065064064064064064065064064064064064065065065065065065065
065065007007064064064064064064064064064064064064064064064064064064064064064064064064064064064064064064064064064064064064064064064065064064065065
065065065065065065065064064064064064064064064064064064064064064064064064064064065064064065064064065064064065064064065064064065065065064064065065
065065065065065065065064064064064064064064064064064064064064064064064064064064065064064064064064065064064064064064065064064064064064064064064064
065065065065065065065064064064064064064064064064064064064064064064064064064064064064064064064064064064064064064064064064064064064064064064064064
065065065065065065065065065065064064064064064064064064064064064064064065065065065065065065065065065065065065065065065065065065065065065065065065
065065065065065065065065065065064064064064064064064064064064064064064065065065065065065065065065065065065065065065065065065065065065065065065065
065065065065065065065065065065064064064064064064064064064064064064064065065065065065065065065065065065065065065065065065065065065065065065065065
065065065065065065065065065065065065065064064064064064064064065065065065065065065065065065065065065065065065065065065065065065065065065065065065
065065065065065065065065065065065065065064064064064064064064065065065065065065065065065065065065065065065065065065065065065065065065065065065065
065065065065065064064064064064064064064064064064064064064064065065065065065065065065065065065065065065065065065065065065065065065065065065065065
065065065065065064064064064064064064064064064064064065065065065065065065065065065065065065065065065065065065065065065065065065065065065065065065
065065065065065064064064064064064064064064064064064065065065065065065065065065065065065065065065065065065065065065065065065065065065065065065065
065065065065065064064064064064064064064064064064064065065065065065065065065065065065065065065065065065065065065065065065065065065065065065065065
064064064064064064064064064064064064064064065065065065065065065065065065065065065065065065065065065065065065065065065065065065065065065065065065
064064064064064064064064064064064064064064065065065065065065065065065065065065065065065065065065065065065065065065065065065065065065065065065065
064064064064064064064064064064064064064064065065065065065065065065065065065065065065065065065065065065065065065065065065065065065065065065065065
065065065065065065065065065065065065065065065065065065065065065065065065065065065065065065065065065065065065065065065065065065065065065065065065
065065065065065065065065065065065065065065065065065065065065065065065065065065065065065065065065065065065065065065065065065065065065065065065065
065065065065065065065065065065065065065065065065065065065065065065065065065065065065065065065065065065065065065065065065065065065065065065065065
