065065065065065065065065065065065065065065065065065065065065065065065065065065065065065065065065065065065065065065065065065065065065065065065065
065065065065065065065065065065065065065065065065065065065065065065065065065065065065065065065065065065065065065065065065065065065065065065065065
065065065065065065065065065065065065065065065065065065065065065065065065065065065065065065065065065065065065065065065065065065065065065065065065
065065064064064064064064064064064064064064064064064064064064064064064064064064064064064064064064064065065065065065065065065065065065065065065065
065065064064064064064064064064064064064064064064064064064064064064064064064064064064064064064064064065065065065065065065065065065065065065065065
065065064064064064064064064064064064064064064064064064064064064064064064064064064064064064064064064065065065065065065065065065065065065065065065
065065064064064064064064064064064064064064064064064064064064064064064064064064064064064064064064064065065065065065065065065065065065065065065065
065065064064064064064064064064064064064064064064064064064064064064064064064064064064064064064064064065065065065065065065065065065065065065065065
065065064064064064064064064064064064064064064064064064064064064064064064064064064064064064064064064065065065065065065065065065065065065065065065
065065064064064064064064064064064064064064064064064064064064064064064064064064064064064064064064064065065065065065065065065065065065065065065065
065065064064064064064064064064064064064064064064064064064064064064064064064064064064064064064064064065065065065065065065065065065065065065065065
065065064064064064064064064064064064064064064064064064064064064064064064064064064064064064064064064065065065065065065065065065065065065065065065
065065007007064064064064064064064064064064064064064064064064064064064064064064064064064064064064064064064064064064064064064064064064065065065065
065065007007064064064064064064064064064064064064064064064064064064064064064064064064064064064064064064064064064064064064064064064064065065065065
065065007007064064064064064064064064064064064064064064064064064064064064064064064064064064064064064064064064064064064064064064064064065065065065
065065065065065065065065065065065065065065065065065065065065065065065065065065065065065065065065065065065065065065065065065065065065065065065065
065065065065065065065065065065065065065065065065065065065065065065065065065065065065065065065065065065065065065065065065065065065065065065065065
065065065065065065065065065065065065065065065065065065065065065065065065065065065065065065065065065065065065065065065065065065065065065065065065
