065065065065065065065065065065065065065065065065065065065065065065065065065065065065065065065065065065065065065065065065065065065065065065065065
065065065065065065065065065065065065065065065065065065065065065065065065065065065065065065065065065065065065065065065065065065065065065065065065
065065065064064064064064064064064064064064064064064064064064064064064064064064064064064064064064064064064064064064064064064064064064064065065065
065065065064064064064064064064064064064064064064064064064064064064064064064064064064064064064064064064064064064064064064064064064064064065065065
065065065064064064064064064064064064064064064064064064064064064064064064064064064064064064064064064064064064064064064064064064064064064065065065
065065065064064064064064064064064064064064064064064064064064064064064064064064064064064064064064064064064064064064064064064064064064064065065065
065065065064064064064064064064064064064064064064064064064064064064064064064064064064064064064064064064064064064064064064064064064064064065065065
065065065064064064064064064064064064064064064064064064064064064064064064064064064064064064064064064064064064064064064064064064064064064065065065
065065065064064064064064064064064064064064064064064064064064064064064064064064064064064064064064064064064064064064064064064064064064064065065065
065065065064064064064064064064064064064064064064064064064064064064064064064064064064064064064064064064064064064064064064064064064064064065065065
065065065064064064064064064064064064064064064064064064064064064064064064064064064064064064064064064064064064064064064064064064064064064065065065
064064064064064064064064064064064064064064064064064064064064064064064064064064064064064064064064064064064064064064064064064064064064064064064064
064064064064064064064064064064064064064064064064064064064064064064064064064064064064064064064064064064064064064064064064064064064064064064064064
064064064064064064064064064064064064064064064064064064064064064064064064064064064064064064064064064064064064064064064064064064064064064064064064
065065065065065065065065065065065065065065065065065065065065065065065065065065065065065065065065065065065065065065065065065065065065065065065065
065065065065065065065065065065065065065065065065065065065065065065065065065065065065065065065065065065065065065065065065065065065065065065065065
065065065065065065065065065065065065065065065065065065065065065065065065065065065065065065065065065065065065065065065065065065065065065065065065
065065065065065065065065065065065065065065065065065065065065065065065065065065065065065065065065065065065065065065065065065065065065065065065065
