000000000000000000000000000000000000000000000000000000000000000000000000000000000000000000000000
000000000000000000000000014000000000000000000000000000014014014014014014000000000000000000000000
000000000000000000014014014014000000000000000000000014014014014014014014000000000000013013000000
000000000000000014014014014014000000000000000000000014014014014014014014000000000000013013000000
000000000000000000000014014000000000000000000000000000014014014014000000000000000000000000000000
000000000000000000000000000000000000000000000000000000000000000000000000000000000000000000000000
000000000000000000000000000000000000000000000000000000000000000000000000000000000000000000000000
000000000000000000000000000000000000000000000000000000000000000000000000000000000000000000000000
000000000000000000000000000000000000000000000000000000000000000000000000000000000000000000000000
000000000000000000000000000000000000000000000000000000000000000000000000000000000000000000000000
000000000000000000000000000000000000000000000000000000000000000000000000000000000000000000000000
000000000000000000000000000000000000000000000000000000000000000000000000000000000000000000000000
000000000000000000000000000000000000000000000000000000000000000000000000000000000000000000000000
000000000000000000000000000000000000000000000000000000000000000000000000000000000000000000000000
055055055055055055055055055055055055055055055055055055055055055055055055055055055055055055055055
055055055055055055055055055055055055055055055055055055055055055055055055055055055055055055055055
002002002002002002002002002002002002002002002002002002002002002002002002002002002002002002002002
002002002002002002002002002002002002002002002002002002002002002002002002002002002002002002002002
