000000000000000000000000000000000000000000000000000000000000000000000000000000000000000000000000000000000000000000000000000000000000000000000000000000000000000000000000000000000000000000000000
000000000000000000000000000000000000000000000000000000000000000000000000000000000000000000000000000000000000000000000000000000000000000000000000000000000000000000000000000000000000000000000000
000000000000000014014014014014000000000000000000000000000000000000000000000000000000000000000000000014014014014000000000000000000000000000000000000000000000000000000000000000000000000000000000
000000000000000000014014014014014000000000000000000000000000000000000000000000000000000000000000014014014014014000000000000000000000000000000000000000000000000000000000000000000000000000000000
000000000000000000014014014000000000000000000000000000000000014014014014000000000000000000000000014014014014014014000000000000000000000014000000000000000000000000000000000000000000000000000000
000000000000000000000000000000000000000000000000000000000000014014014014014000000000000000000000000000000000014000000000000000000000014014014014000000000000000000000000000000000000000000000000
000000000000000000000000000000000000000000000000000000000000000000000000000000000000000000000000000000000000000000000000000000000014014014014014000000000000000000000000000000000000000000000000
000000000000000000000000000000000000000000000000000000000000000000000000000000000000000000000000000000000000000000000000000000000000014000000000000000000000000000000000000000000000000000000000
000000000000000000000000000000000000000000000000000000000000000000000000000000000000000000000000000000000000000000000000000000000000000000000000000000000000000000000000000000000000000000000000
000000000000000000000000000000000000000000000000000000000000000000000000000000000000000000000000000000000000000000000000000000000000000000000000000000000000000000000000000000000000000000000000
000000000000000000000000000000000000000000000000000000000000000000000000000000000000000000000000000000000000000000000000000000000000000000000000000000000000000000000000000000000000002002002002
000000000000000000000000000000000000000000000000000000000000000000000000000000000000000000000000000000000000000000000000000000000000000000000000000000000000000000000000000000002002002002002002
002002002000000000000000000000000000000000000000000000000000000000000000000000000000000000000000000000000000000000000000000000002000000000000000000000000000000000000000002002002002002001001001
002002002002002002002000000000000000000000000000000000000000002002002002000000000000000000000000000000000000000000000000000002002000000000000000000000000002002002002002002002002001001001001001
001001002002002002002002002002002002002002002002002002002002002002002002002002002002002002002002002002002002002002002002002002002002002002002002002002002002002002002002002001001001001001001001
001001001001001001002002002002002002002002002002002002002002002001001002002002002002002002002002002002002002002002002002002002001002002002002002002002002002001001001001001001001001001001001001
001001001001001001001001001001001001001001001001001001001001001001001001001001001001001001001001001001001001001001001001001001001001001001001001001001001001001001001001001001001001001001001001
001001001001001001001001001001001001001001001001001001001001001001001001001001001001001001001001001001001001001001001001001001001001001001001001001001001001001001001001001001001001001001001001
