051051051051051051051051051051051051051051051051051051051051051051051051051051051051011051051051
051051051051051051051051051051051051051051051051051051051051051051051051051051051051051051051051
051051051051051051051051051051051051051051051051051051051051051051051051051051051051051051051051
051011051051051051051051051051051051051051051051051051051051051051051051051051051051051051051051
051051051051051051051051051051051051051051051051051051051051051051051051051051051051051051051051
051051032032032032032032032032032032032032032032032032032032032032032032032032032032032032051051
051051032032032032032032032032032032032032032032032032032032032032032032032032032032032032051051
051051032032032032032032032032032032032032032032032032032032032032032032032032032032032032051051
051051032032032032032032032032032032032032032032032032032032032032032032032032032032032032051051
051051032032032032032032032032032032032032032032032032032032032032032032032032032032032032051051
051051032032006006006006032006006006006032006006006006032006006006006006006032032032032032051051
032032032032006006006006032006006006006032006006006006032006006006006006006032032032032007051051
032032032032006006006006032006006006006032006006006006032006006006006006006032032032032016051051
051051051051051051051051051051051051051051051051051051051051051051051051051051051051051051051051
051051051051051051051051051051051051051051051051051051051051051051051051051051051051051051051051
051051051051051051051051051051051051051051051051051051051051051051051051051051051051051051051051
051051051051051051051051051051051051051051051051051051051051051051051051051051051051051051051051
051051051051051051051051051051051051051051051051051051051051051051051051051051051051051051051051
