000000000000000000000000000000000000000000000000000000000000000000000000000000000000000000000000000000000000000000000000000000000000000000000000000000000000000000000000000000000000000000000000
000000000000000000000000000000000000000000000000000000000000000000000000000000000000000000000000000000000000000000000000000000000000000000000000000000000000000000000000000000000000000000000000
000000000000000000000000000000000000000000000000000000000000000000000000000000000000000000000000000000000000000000000000000000000000000000000000000000000000000000000000000000000000000000000000
000000000014014014000000000000000000000000000000000000014014014000000000000000000000000000014014014014000000000000000000000000000000000000000000000000000000000000000000014014014014000000000000
000000014014014014000000000000000000000000000000000000014014014014000000000000000000000000014014014000000000000000000000000000000000000000000000000000000014014014014014014014014000000000000000
000000000000000000000000000000000000000000000000000000000000000000000000000000000000000000000000000000000000000000000000000000000000000000000000000000014014014014014014014014014000000000000000
000000000000000000000000000000000000000000000000000000000000000000000000000000000000000000000000000000000000000000000000000000000000000000000000000000014014014000000000000000000000000000000000
000000000000000000000000000000000000000000000000000000000000000000000000000000000000000000000000000000000000000000000000000000000000000000000000000000000000000000000000000000000000000000000000
000000000000000000000000000000000000000000000000000000000000000000000000000000000000000000000000000000000000000000000000000000000000000000000000000000000000000000000000000000000000000000000000
000000000000000000000000000000000000000000000000000000000000000000000000000000000000000000000000000000000000000000000000000000000000000000000000000000000000000000000000000000000000000000000000
036036036036036036036036036036036036036036036036036036036036036036036036036036036036036036036036036036036036036036036036036036036036036036036036036036036036036036036036036036036036036036036036
036036036036036036036036036036036036036036036036036036036036036036036036036036036036036036036036036036036036036036036036036036036036036036036036036036036036036036036036036036036036036036036036
035035035035035035035035035035035035035035035035035035035035035035035035035035035035035035035035035035035035035035035035035035035035035035035035035035035035035035035035035035035035035035035035
035035035035035035035035035035035035035035035035035035035035035035035035035035035035035035035035035035035035035035035035035035035035035035035035035035035035035035035035035035035035035035035035
035035035035035035035035035035035035035035035035035035035035035035035035035035035035035035035035035035035035035035035035035035035035035035035035035035035035035035035035035035035035035035035035
035035035035035035035035035035035035035035035035035035035035035035035035035035035035035035035035035035035035035035035035035035035035035035035035035035035035035035035035035035035035035035035035
012012012012012012012006006006012012012012012012012012012012012012012012012012012012012012012012006006006012012012012012012012012012012012012012012012012012012012012012012006006006012012012012
012012012012012012012006006006012012012012012012012012012012012012012012012012012012012012012012006006006012012012012012012012012012012012012012012012012012012012012012012006006006012012012012
