000000000000000000000000000000000000000000000000000000000000000000000000000000000000000000000000000000000000000000000000000000000000000000000000000000000000000000000000000000000000000000000000
000000000000000000000000000000000000000000000000000000000000000000000000000000000000000000000000000000000000000000000000000000000000000000000000000000000000000000000000000000000000000000000000
000000014014000000000000000000000000000000000000000000000000000000000000000000000000000000000000000000000000000000000000000000000000000000000000000000000000000000000000000000000000000000000000
000014014014000000000000000000000000000000000000000000000000000000000000000014000000000000000000000000000000000000000014000000000000000000000000000000000000000000000014014014014014000000000000
000014014014014000000000000000000000000000000000000000000000000000014014014014000000000000000000000000000000000014014014000000000000000000000000000000000000000000000014014014014000000000000000
000000000000000000000000000000000000000000000000000000000000014014014014014000000000000000000000000000000000000014014014014014014000000000000000000000000000000000000000000000014000000000000000
000000000000000000000000000000000000000000000000000000000000000000000000000000000000000000000000000000000000000000000000014014014000000000000000000000000000000000000000000000000000000000000000
000000000000000000000000000000000000000000000000000000000000000000000000000000000000000000000000000000000000000000000000000000000000000000000000000000000000000000000000000000000000000000000000
000000000000000000000000000000000000000000000000000000000000000000000000000000000000000000000000000000000000000000000000000000000000000000000000000000000000000000000000000000000000000000000000
036036036036036036036036036036036036036036036036036036036036036036036036036036036036036036036036036036036036036036036036036036036036036036036036036036036036036036036036036036036036036036036036
036036036036036036036036036036036036036036036036036036036036036036036036036036036036036036036036036036036036036036036036036036036036036036036036036036036036036036036036036036036036036036036036
036036036036036036036036036036036036036036036036036036036036036036036036036036036036036036036036036036036036036036036036036036036036036036036036036036036036036036036036036036036036036036036036
036036036036036036036036036036036036036036036036036036036036036036036036036036036036036036036036036036036036036036036036036036036036036036036036036036036036036036036036036036036036036036036036
036036036036036036036036036036036036036036036036036036036036036036036036036036036036036036036036036036036036036036036036036036036036036036036036036036036036036036036036036036036036036036036036
003003003003003003003003003003003003003003003003003003003003003003003003003003003003003003003003003003003003003003003003003003003003003003003003003003003003003003003003003003003003003003003003
003003003003003003003003003003003003003003003003003003003003003003003003003003003003003003003003003003003003003003003003003003003003003003003003003003003003003003003003003003003003003003003003
003003003003003003003003003003003003003003003003003003003003003003003003003003003003003003003003003003003003003003003003003003003003003003003003003003003003003003003003003003003003003003003003
003003003003003003003003003003003003003003003003003003003003003003003003003003003003003003003003003003003003003003003003003003003003003003003003003003003003003003003003003003003003003003003003
