008008008008008008008008008008008008008008008008008008008008008008008008008008008008008008008008008008008008008008008008008008008008008008008008008008008008008008008008008008008008008008008008
008008008008008008008008008008008008008008008008008008008008008008008008008008008008008008008008008008008008008008008008008008008008008008008008008008008008008008008008008008008008008008008008
008008008008008008008008008008008008008008008008008008008008008008008008008008008008008008008008008008008008008008008008008008008008008008008008008008008008008008008008008008008008008008008008
008008008008008008008008008008008008008008008008008008008008008008008008008008008008008008008008008008008008008008008008008008008008008008008008008008008008008008008008008008008008008008008008
008008008008008008008008008008008008008008008008008008008008008008008008008008008008008008008008008008008008008008008008008008008008008008008008008008008008008008008008008008008008008008008008
008008008008008008008008008008008008008008008008008008008008008008008008008008008008008008008008008008008057037037008008008008008008008008008008008056004004008008008008008008008008008008008008
058058008008008008008008008008008008008008008008008008008008008008058037037037057058008008008008008008057057037037056056008008008008008008057057058056004004057058058037037037008008008008056058
058058004056004008008008008008057058037037037004004008008008008057058037037037057058056008004008008058057057037037056056058008008008004057057057058056004004057058058037037037058058056056058058
058058004004004004057056057057057058037037037004004004008008057057058037037037057058056056004004058058057057037037056056058058058004004057057057058056004004057058058037037037058058056056058058
058058058056004004057057057057058058037037037004004056056058057057058037037037057058056056004004058058057057037037056056058058058004004057057057058056004004057058058037037037058058056056058058
058058058056004004058056057057058058037037037004004056056058057057058037037037057058056056004004058058057057037037056056058058058004004057057057056056004004057058058037037037058058056056058058
058058056056004004058056057057058037037037004004004056056058057057058037037037057056056056004004058058057037037037056056056058058004004004057057056056004004057058058037037037058056056056058058
058058056004004004058056057057058037037037004004004056056057057057058037037037037056056004004004058057057037037037037056056058004004004004057057057056004004057057058037037037037056056056056058
002002002002002002002002002002002002002002002002002002002002002002002002002002002002002002002002002002002002002002002002002002002002002002002002002002002002002002002002002002002002002002002002
002002002002002002002002002002002002002002002002002002002002002002002002002002002002002002002002002002002002002002002002002002002002002002002002002002002002002002002002002002002002002002002002
002002002002002002002002002002002002002002002002002002002002002002002002002002002002002002002002002002002002002002002002002002002002002002002002002002002002002002002002002002002002002002002002
002002002002002002002002002002002002002002002002002002002002002002002002002002002002002002002002002002002002002002002002002002002002002002002002002002002002002002002002002002002002002002002002
002002002002002002002002002002002002002002002002002002002002002002002002002002002002002002002002002002002002002002002002002002002002002002002002002002002002002002002002002002002002002002002002
