007007007007007007007007007007007007007007007007007007007007007007007007007007007007007007007007
007007007007007007007007007007007007007007007007007007007007007007007007007007007007007007007007
007007007007007007007007007007007007007007007007007007007007007007007007007007007007007007007007
007007007007007007007007007007007007007007007007007007007007007007007007007007007007007007007007
007007007007007007007007007007007007007007007007007007007007007007007007007007007007007007007007
038038038038038038038038038038038038038038038038038038038038038038038038038038038038038038038038
038038038038038038038038038038038038038038038038038038038038038038038038038038038038038038038038
038038042042042042042042042042042042042042042042042042042042042042042042042042042042042042038038
038038042042042042042042042042042042042042042042042042042042042042042042042042042042042042038038
038038042042042042042042042042042042042042042042042042042042042042042042042042042042042042038038
015037042042042042042042042042042042042042042042042042042042042042042042042042042042042042038038
016037042042042042042042042042042042042042042042042042042042042042042042042042042042042042038038
038038038038038038038038038038038038038038038038038038038038038038038038038038038038038038038038
038038038038038038038038038038038038038038038038038038038038038038038038038038038038038038038038
007007007007007007007007007007007007007007007007007007007007007007007007007007007007007007007007
007007007007007007007007007007007007007007007007007007007007007007007007007007007007007007007007
007007007007007007007007007007007007007007007007007007007007007007007007007007007007007007007007
007007007007007007007007007007007007007007007007007007007007007007007007007007007007007007007007
