038038038038038038038038038038038038038038038038038038038038038038038038038038038038038038038038
038038038038038038038038038038038038038038038038038038038038038038038038038038038038038038038038
038038042042042042042042042042042042042042042042042042042042042042042042042042042042042042038038
038038042042042042042042042042042042042042042042042042042042042042042042042042042042042042038038
038038042042042042042042042042042042042042042042042042042042042042042042042042042042042042038038
038038042042042042042042042042042042042042042042042042042042042042042042042042042042042042038038
038038042042042042042042042042042042042042042042042042042042042042042042042042042042042042038038
038038042042042042042042042042042042042042042042042042042042042042042042042042042042042042038038
038038042042042042042042042042042042042042042042042042042042042042042042042042042042042042038038
038038038038038038038038038038038038038038038038038038038038038038038038038037037037035035038038
038038042042042042042042042042042042042042042042042042042042042042042042042042042042035035038038
038038042042042042042042042042042042042042042042042042042042042042042042042042042035035035038038
038038042042042042042042042042042042042042042042042042042042042042042042042042042035035035038038
038038042042042042042042042042042042042042042042042042042042042042042042042042035035035035038038
015037042042042042042042042042042042042042042042042042042042042042042042042042035035035035038038
016037042042042042042042042042042042042042042042042042042042042042042042042035035035035035038038
038038038038038038038038038038038038038038038038038038038038038038038038038038038038038038038038
038038038038038038038038038038038038038038038038038038038038038038038038038038038038038038038038
