000000000000000000000000000000000000000000000000000000000000000000000000000000000000000000000000000000000000000000000000000000000000000000000000
000000000000000000000000000000000000000000000000000000000000000000000000000000000000000000000000000000000000000000000000000000000000000000000000
000000000000000000000000000000000000000000000000000000000000000000000000000000000000000000000000000000000000000000000000000000000000000000000000
000000000000000000000000000000000000000000000000000000000000000000000000000000000000000000000000000000000000000000000000000000000000000000000000
000000000000000000000000000000000000000000000000000000000000000000000000000000000000000000000000000000000000000000000000000000000000000000000000
000000000000000000034034034034034000000000000000000000000000000000000000000000000000000000000000000000000000000000000000000000000000000000000000
000000000000000000034034034034034034000000000000000000000000000000000000000000000000000000000000000000000000000000000000000000000000000000000000
000000000000000034034034034034034034034000000000000000000000000000000000000000000000000000000000000000000000000000000000000000000000000000000000
000000000000000034034033033034034034034000000000000000000000000000000000000000000000000000000000000000000000000000000000000000000000000000000000
000000000000034034034033033034034034034034000000000000000000000000000000000000000000000000000000000000000000000000000000000000000000000000000000
000000000000034034033033033034034034034034000000000000000000000000000000000000000000000000000000000000000000000000000000000000000000000000000000
033033033033033033033033033033033033033034000000000000000000000000000000000000000000000000000000000000000000000000000000000000000000000000000000
033033033033033033033033033033033033033034000000000000000000000000000000000000000000000000000000000000000000000000000000000000000000000000000000
033033033033033033033033033033033033033033033033000000000000000033033033033000000000000000000000000000000000000000000000000000000000000000000000
033033033033033033033033033033033033033033033033000000000033033033033033033033033033033000000000000000033033033033033033000000000000000000000000
033033033033033033033033033033033033033033033033034034034033033033033033033033033033033034000000033033033033033033033033033033033033000000000000
033033033033033033033033033033033033033033033033033034034033033033033033033033033033033034034034033033033033033033033033033033033033033033033033
033033033033033033033033033033033033033033033033033034034033033033033033033033033033033034034034033033033033033033033033033033033033033033033033
