007007007007007007007007007007007007007007007007007007007007007007007007007007007007007007007007
038038038038038038038038038038038038038038038038038038038038038038038038038038038038038007007007
038038038038038038038038038038038038038038038038038038038038038038038038038038038038038007007007
007037037037037037037037037037037037037037037037037037037037037037037037037037037038038007007007
007037037037037037037037037037037037037037037037037037037037037037037037037037037038038007007007
007037037037037037037037037037037037037037037037037037037037037037037037037037037038038007007007
038038037037037037037037037037037037037037037037037037037037037037037037037037037038038007007007
038038038038038038038038038038038038038038038038038038038038038038038038038038038038038007007007
038038038038038038038038038038038038038038038038038038038038038038038038038038038038038007007007
007007007007007007007007007007007007007007007007007007007007007007007007007007007007007007007007
007007007007007007007007007007007007007007007007007007007007007007007007007007007007007007007007
007007007007007007007007007007007007007007007007007007007007007007007007007007007007007007007007
007007007007007007007007007007007007007007007007007007007007007007007007007007007007007007007007
007007007007007007007007007007007007007007007007007007007007007007007007007007007007007007007007
007007007007007007007007007007007007007007007007007007007007007007007007007007007007007007007007
007007007007007007007007007007007007007007007007007007007007007007007007007007007007007007007007
007007007007007007007007007007007007007007007007007007007007007007007007007007007007007007007007
007007007007007007007007007007007007007007007007007007007007007007007007007007007007007007007007
