000000000000000000000000000000000000000000000000000000000000000000000000000000000000000000000000000000000000000000000000000000000000000000000000
000000000000000000000000000000000000000000000000000014014000000000000000000000000000000000000000000000000000000000000000000000000000000000000000
000000000000000000000000000000000000000000000014014014014014014000000000000000000051051000000000014000000014014000000000000000000000000000000051
000014014014000000000000000000000000000000000014014014014014000000000000000000000051051000000000014014014014014000000000000000000000000000000051
000014014014000000000000000000000000000000000000000000000000000000000000000000000051051000000000000000000000000000000000000000000000000000000051
000000014000000000000000000000000000000000000000000000000000000000000000000000000051051000000000000000000000000000000000000000000000000000000051
000000000000000000000000000000000000000000000000000000000000000000000000000000051051051051000000000000000000000000000000000000000000000000051051
000000000000000000000000000000000000000000000000000000000000000000000000000000051051051051000000000000000000000000000000000000000000000000051051
000000000000000000000000000014014014014014000000000000000000000000000000000000051051051051000000000000000000000000000000014014014000000000051051
000000000000000000000000000014014014014014000000000000000000000000000000000000051051051051000000000000000000000000000000014014014014000000051051
000000000000000000000000000000014014014000000000000000000000000000000000000000051051051051000000000000000000000000000000000000000000000000051051
000000000000000000000000000000000000000000000000000000000000000000000000000000051051051051032032032032032032032032032032032032032032032032051051
000000000000000000000000000000000000000000000000000000000000000000000000000000051051051051051051051051051051051051051051051051051051051051051051
000000000000000000000000000000000000000000000000000000000000000000000000000000051051051051051051051051051051051051051051051051051051051051051051
000000000000000000000000000000000000000000000014014014014000000000000000000000051051051051014014000000000000000000000000000000000000000000051051
000000000000000000000000000000000000000000014014014014000000000000000000000000051051051051000000000000000000000000000000000000000000000000051051
000000000000000000000000000000000000000000000000000000000000000000000000000000051051051051000000000000000000000000000000000000000000000000051051
000000000000000000000000000000000000000000000000000000000000000000000000000000051051051051000000000000000000000000000000000000000000000000051051
000000000000000000000000000000000000000000000000000000000000000000000000000000051051051051000000000000000000000000000000014014000000000000051051
000000000000014014000000000000000000000000000000000000000000000000000000000000051051051051000000000000000000000000000014014014000000000000051051
000000000000000014014000000000000000000000000000000000000000000000000014000000051051051051000000000000000000000000000000000000000000000000051051
000000000000000000000000000000000000000000000000000000000000000000014014000000051051051051000000014014000000000000000000000000000000000000051051
000000000000000000000000000000000000000000000000000000000000000000000000000000032032032032000000000000000000000000000000000000000000000000032032
036036036036036036036036036036036036036036036036036036036036036036036036036036032032032032036036036036036036036036036036036036036036036036032032
036036036036036036036036036036036036036036036036036036036036036036036036036036032032032032036036036036036036036036036036036036036036036036032032
032032032032032032032032032032032032032032032032032032032032032032032032032032032032032032032032032032032032032032032032032032032032032032032032
051051051051051051051051051051051051051051051051051051051051051051051051051051051051051051051051051051051051051051051051051051051051051051051051
051051051051051051051051051051051051051051051051051051051051051051051051051051051051051051051051051051051051051051051051051051051051051051051051
051051051051051051051051051051051051051051051051051051051051051051051051051051051051051051051051051051051051051051051051051051051051051051051051
051051051051051051051051051051051051051051051051051051051051051051051051051051051051051051051051051051051051051051051051051051051051051051051051
012012051051051051012012012012012012012012012012012012012012012012012012012012051051051051012012012012012012012012012012012012012012012012012012
012012051051051051012012012012012012012012012012012012012012012012012012012012051051051051012012012012012012012012012012012012012012012012012012
012012051051051051012012012012012012012012012012012012012012012012012012012012051051051051012012012012012012012012012012012012012012012012012012
012012051051051051012012012012012012012012012012012012012012012012012012012012051051051051012012012012012012012012012012012012012012012012012012
012012051051051051012012012012012012012012012012012012012012012012012012012012051051051051012012012012012012012012012012012012012012012012012012
012012051051051051012012012012012012012012012012012012012012012012012012012012051051051051012012012012012012012012012012012012012012012012012012
