007007007007007007007007007007007007007007007007007007007007007007007007007007007007007007007007
007007007007007007007007007007007007007007007007007007007007007007007007007007007007007007007007
007007007007007007007007007007007007007007007007007007007007007007007007007007007007007007007007
038038038038038038038038038038038038038038038038038038038038038038038038038038038038038038038038
038038038038038038038038038038038038038038038038038038038038038038038038038038038038038038038038
038038038038038038038038038038038038038038038038038038038038038038038038038038038038038038038038
038038037037037037037037037037037037037037037037037037037037037037037037037037037037037037038038
038038037037037037037037037037037037037037037037037037037037037037037037037037037037037037038038
038038037037037037037037037037037037037037037037037037037037037037037037037037037037037037038038
007037037037037037037037037037037037037037037037037037037037037037037037037037037037037037038038
007037037037037037037037037037037037037037037037037037037037037037037037037037037037037037038038
007037037037037037037037037037037037037037037037037037037037037037037037037037037037037037038038
038038038038038038038038038038038038038038038038038038038038038038038038038038038038038038038038
038038038038038038038038038038038038038038038038038038038038038038038038038038038038038038038038
038038038038038038038038038038038038038038038038038038038038038038038038038038038038038038038038
007007007007007007007007007007007007007007007007007007007007007007007007007007007007007007007007
007007007007007007007007007007007007007007007007007007007007007007007007007007007007007007007007
007007007007007007007007007007007007007007007007007007007007007007007007007007007007007007007007
