054054054054054054054054054054054054054054054054054054054054054054054054054054054054054054054054
054054054054054054054054054054054054054054054054054054054054054054054054054054054054054054054054
054054054054054054054054054054054054054054054054054054054054054054054054054054054054054054054054
068068068068068068068068068068068068068068068068068068068068068068068068068068068068068068068068
068068068068068068068068068068068068068068068068068068068068068068068068068068068068068068068068
068068068068068068068068068068068068068068068068068068068068068068068068068068068068068068068068
068068046046046046046046046046046046046046046046046046046046046046046046046046068068068068068068
068068046046046046046046046046046046046046046046046046046046046046046046046046068068068068068068
068068046046046046046046046046046046046046046046046046046046046046046046046046068068068068068068
046046046046046046046046046046046046046046046046046046046046046046046046046046068068068068068068
046046046046046046046046046046046046046046046046046046046046046046046046046046069068068068068068
046046046046046046046046046046046046046046046046046046046046046046046046046046070068068068068068
068068068068068068068068068068068068068068068068068068068068068068068068068068068068068068068068
068068068068068068068068068068068068068068068068068068068068068068068068068068068068068068068068
068068068068068068068068068068068068068068068068068068068068068068068068068068068068068068068068
054054054054054054054054054054054054054054054054054054054054054054054054054054054054054054054054
054054054054054054054054054054054054054054054054054054054054054054054054054054054054054054054054
054054054054054054054054054054054054054054054054054054054054054054054054054054054054054054054054
