065065065065065065065065065065065065065065065065065065065065065065065065065065065065065065065065065065065065065065065065065065065065065065065065
065065065065065065065065065065065065065065065065065065065065065065065065065065065065065065065065065065065065065065065065065065065065065065065065
065061061061061065065065065065065065065065065065065065065065065065065065065065065065065065065065065065065065065061061061061065065065065065065065
065061064064064064064064064064064064064064064064064064064064064064064064064064064064064064064064064064064064064064064064061065065065065065065065
065061064064064064064064064064064064064064064064064064064064064064064064064064064064064064064064064064064064064064064064061065065065065065065065
065061064064064064064064064064064064064064064064064064064064064064064064064064064064064064064064064064064064064064064064061065065065065065065065
065065064064064064064064064064064064064064064064064064064064064064064064064064064064064064064064064064064064064064064064065065065065065065065065
065065064064064064064064064064064064064064064064065065065065065065065065065065064064064064064064064064064064064064064064065065065065065065065065
065065064064064064064064064064064065065065064064064064064064064064064064064064064064065065065064064064064064064064064064065065065065065065065065
065065064064064065065065065064064064064064064064064064064064064064064064064064064064064064064064064065065065065064064064065065065065065065065065
065065064064064064064064064064064064064064064064064064064064064064064064064064064064064064064064064064064064064064064064065065065065065065065065
065065064064064064064064064064064064064064064064064064064064064064064064064064064064064064064064064064064064064064064064065065065065065065065065
064064064064064064064064064064064064064064064064064064064064064064064064064064064064064064064064064064064064064064064064064064064064007007065065
064064064064064064064064064064064064064064064064064064064064064064064064064064064064064064064064064064064064064064064064064064064064007007065065
064064064064064064064064064064064064064064064064064064064064064064064064064064064064064064064064064064064064064064064064064064064064007007065065
065065065065065065065065065065065065065065065065065065065065065065065065065065065065065065065065065065065065065065065065065065065065065065065065
065065065065065065065065065065065065065065065065065065065065065065065065065065065065065065065065065065065065065065065065065065065065065065065065
065065065065065065065065065065065065065065065065065065065065065065065065065065065065065065065065065065065065065065065065065065065065065065065065
