065065065065065065065065065065065065065065065065065065065065065065065065065065065065065065065065065065065065065065065065065065065065065065065065
065065065065065065065065065065065065065065065065065065065065065065065065065065065065065065065065065065065065065065065065065065065065065065065065
065065065065065065065065065065065065065065065065065065065065065065065065065065065065065065065065065065065065065065065065065065065065065065065065
065065065065065065065065065065065065065065065065065065065065065065065065065065065065065065065065065065065065065065065065065065065065065065065065
065065064064064064064064064064064064064064064064064064064064064064064064064064064064064064064064064064064064064064064064064064064064064064064064
065065064064064064064064064064064064064064064064064064064064064064064064064064064064064064064064064064064064064064064064064064064064064064064064
065065064064064064064064064064064064064064064064064064064064064064064064064064064064064064064064064064064064064064064064064064064064064064064064
065065064064064064064064064064064064064064064064064064064064064064064064064064064064064064064064064064064064064064064064064064064064064064064064
065065064064064064064064064064064064064064064064064064064064064064064064064064064064064064064064064064064064064064064064064064064064064064064064
065065064064064064064064064064064064064064064064064064064064064064064064064064064064064064064064064064064064064064064064064064064064064064064064
065065064064064064064064064064064064064064064064064064064064064064064064064064064064064064064064064064064064064064064064064064064064064064064064
065065007007064064064064064064064064064064064064072072072064064064064072072072064064064064072072072064064064064064064064064064064064064064064064
065065007007064064064064064064064064064064064064072076072064064064064072076072064064064064072076072064064064064064064064064064064064064064064064
065065007007064064064064064064064064064064064064072077072064064064064072077072064064064064072077072064064064064064064064064064064064064064064064
065065065065065065065065065065065065065065065065065065065065065065065065065065065065065065065065065065065065065065065065065065065065065065065065
065065065065065065065065065065065065065065065065065065065065065065065065065065065065065065065065065065065065065065065065065065065065065065065065
065065065065065065065065065065065065065065065065065065065065065065065065065065065065065065065065065065065065065065065065065065065065065065065065
065065065065065065065065065065065065065065065065065065065065065065065065065065065065065065065065065065065065065065065065065065065065065065065065
