000000000000000000000000000000000000000000000000000000000000000000000000000000000000000000000000000000000000000000000000000000000000000000000000000000000000000000000000000000000000000000000000
000000000000000000000000000000000000000000000000000000000000000000000000000000000000000000000000000000000000000000000000000000000000000000000000000071071071000000000071071071000000000071071071
000000000000000000000000000000000000000000000000000000000000000000000000000000000000000000000000000000000000000000000000000000000000000000000000000071071071000000000071071071000000000071071071
000000000000000000000000000000000000000000000000000000000000000000000000000000000000000000000000000000000000000000000000000000000000000000000000000071071071000000000071071071000000000071071071
000000000000000000000000000000000000000000000000000000000000000000000000000000000000000000000000000000000000000000000000000000000000000000000000000071071071071071071071071071071071071071071071
000000000000000000000000000000000000000000000000000000000000000000000000000000000000000000000000000000000000000000000000000000000000000000000000000071071071071071071071071071071071071071071071
000000000000000000000000000000000000000000000000000000000000000000000000000000000000000000000000000000000000000000000000000000000000000000000000000071071071071071071071071071071071071071071071
000000000000000000000000000000000000000000000000000000000000000000000000000000000000000000000000000000000000000000000000000000000000000000000000000071071071071071071071071071071071071071071071
000000000000000000000000000000000000000000000000000000000000000000000000000000000000000000000000000000000000000000000000000000000000000000000000000071071071071071071071071071071071071071071071
000000000000000000000000000000000000000000000000000000000000000000000000000000000000000000000000000000000000000000000000000000000000000000000000000071071071071071071071071071071071071071071071
000000000000000000000000000000000000000000000000000000000000000000000000000000000000000000000000000000000000000000000000000000000000000000000000000071071071071071071071071071071071071071071071
000000000000000000000000000000000000000000000000000000000000000000000000073073073000000000000000000000073000000000000000000000000000000000000000000071071071071071071071071071071071071071071071
000000000000000000000000000000000000000000000000000000000000000000000000072072072000000000000000000072072072000000000000000000000000000000000000000071071071071071071071071071071071071071071071
000000000000000000000000000000000000000000000000000000000000000000000000072072072000000000000000000072072072000000000000000000000000000000000000000071071071071071071071071071071071071071071071
000000000000000000000000000000000000000000000000000000000000000000000000072072072000000000000000000072072072000000000000000000000000000000000000000071071071071071071071071071071071071071071071
000000000000000000000000000000000000000000000000000000000000000000000000072071071000000000000000000072072072000000000000000000000000000000000000000071071071071071071071071071071071071071071071
000000000000000000000000000000000000000000000000000000000000000000000000000072000000000000000000000071071071000000000000000000000000000000000000000071071071071071071071071071071071071071071071
000000000000000000000000000000000000000000000000000000000000000000000000000072000000000000000000000000072000000000000000000000000000000000000000000071071071071071071071071071071071071071071071
000000000000000000000000000000000000000000000000000000000000002000000000000072000000000000000000000000072000000000000000000000000000000000000000000071071071071071071071071071071071071071071071
000000000000000000000000000000000000000000000000000000000000002000000000000072000000000000000000000000072000000000000000000000000000000000000000071071071071071071071071071071071071071071071071
000000000000000000000000000000000000000000000000000000000000002002000000000072000000000000000000000000072000000000000000000000000000000000000000000072072072072072072072072072072072072072072072
000000000000000000000000000000000000000000000000000000002002002002000000000072000000000000000000000000072000000000000000000000000000000000000000000072072072072072072072072072072072072072072072
002002002002002002002002002002002002002002002002002002002002002002035035035035035035035035035035035035035035035035035035035035035035035035035035035071071071071071071071071071071071071071071071
002002002002002002002002002002002002002002002002002002002002002002035035035035035035035035035035035035035035035035035035035035035035035035035035035071071071071071071071071071071071071071071071
001001001001001001001001001001001001001001001001001001001001001001012012012072012012012012012012012012072012012012012012012012012012012012012012012071071071071071071071071071071071071071071071
001001001001001001001001001001001001001001001001001001001001001001012012012072012012012012012012012012072012012012012012012012012012012012012012012071071071071071071071071071071071071071071071
001001001001001001001001001001001001001001001001001001001001001001012012012072012012012012012012012012072012012012012012012012012012012012012012012071071071071071071071071071071071071071071071
