071071071071071071071071071071071071071071071071071071071071071071071071071071071071071071071071071071071071071071071071071071071071071071071071071071071071071071071071071071071071071071071071
071071071071071071071071071071071071071071071071071071071071071071071071071071071071071071071071071071071071071071071071071071071071071071071071071071071071071071071071071071071071071071071071
071071071071071071071071071071071071071071071071071071071071071071071071071071071071071071071071071071071071071071071071071071071071071071071071071071071071071071071071071071071071071071071071
071071071071071071071071071071071071071071071071071071071071071071071071071071071071071071071071071071071071071071071071071071071071071071071071071071071071071071071071071071071071071071071071
071071071071071071071072072072072072072072072072072072072072072072072072072072071071071071071071071071071071071071072072072072072072072072072072072072072072072072072072072071071071071071071071
071071071071071071072072072072072072072072072072072072072072072072072072072072072072071071071071071071071071072072072072072072072072072072072072072072072072072072072072072072071071071071071071
071071071071071071072072072072072072072072072072072072072072072072072072072072072072072071071071071071071072072072072072072072072072072072072072072072072072072072072072072072071071071071071071
071071071071071071072072072072072072072072072072072072072072072072072072072072072072072072071071071071072072072072072072072072072072072072072072072072072072072072072072072072071071071071071071
071071071071071071072072072072072072072072072072072072072072072072072072072072072072072072071071071071072072072072072072072072072072072072072072072072072072072072072072072072071071071071071071
071071071071071071072072072072072072072072072072072072072072072072072072072072072072072072071071071071072072072072072072072072072072072072072072072072072072072072072072072072071071071071071071
071071071071071071072072072072072072072072072072072072072072072072072072072072072072072072072071071072072072072072072072072072072072072072072072072072072072072072072072072072071071071071071071
071071071071071071072072072072072072072072072072072072072072072072072072072072072072072072072071071072072072072072072072072072072072072072072072072072072072072072072072072072071071071071071071
071071071071071071072072072072072072072072072072072072072072072072072072072072072072072072072072072072072072072072072072072072072072072072072072072072072072072072072072072072071071071071071071
071071071071071071072072072072072072072072072072072072072072072072072072072072072072072072072007007072072072072072072072072072072072072072072072072072072072072072072072072072071071071071071071
071071071071071071072072072072072072072072072072072072072072072072072072072072072072072072072007007072072072072072072072072072072072072072072072072072072072072072072072072072071071071071071071
071071071071071071072072072072072072072072072072072072072072072072072072072072072072072072072007007072072072072072072072072072072072072072072072072072072072072072072072072072071071071071071071
071071071071071071072072072072072072072072072072072072072072072072072072072072072072072071071071071071071072072072072072072072072072072072072072072072072072072072072072072072071071071071071071
071071071071071071072072072072072072072072072072072072072072072072072072072072072072072071071071071071071072072072072072072072072072072072072072072072072072072072072072072072071071071071071071
071071071071071071072072072072072072072072072072072072072072072072072072072072072072071071071071071071071071072072072072072072072072072072072072072072072072072072072072072072071071071071071071
071071071071071071072072072072072072072072072072072072072072072072072072072072072072071071071071071071071071072072072072072072072072072072072072072072072072072072072072072072071071071071071071
071071071071071071072072072072072072072072072072072072072072072072072072072072072071071071071071071071071071071072072072072072072072072072072072072072072072072072072072072072071071071071071071
071071071071071071072072072072072072072072072072072072072072072072072072072072072071071071071071071071071071071072072072072072072072072072072072072072072072072072072072072072071071071071071071
071071071071071071072072072072072072072072072072072072072072072072072072072072071071071071071071071071071071071071072072072072072072072072072072072072072072072072072072072072071071071071071071
071071071071071071072072072072072072072072072072072072072072072072072072072072071071071071071071071071071071071071072072072072072072072072072072072072072072072072072072072072071071071071071071
071071071071071071072072072072072072072072072072072072072072072072072072072071071071071072072072072072072071071071071072072072072072072072072072072072072072072072072072072072071071071071071071
071071071071071071072072072072072072072072072072072072072072072072072072071071071072072072072072072072072072072071071071072072072072072072072072072072072072072072072072072072071071071071071071
071071071071071071072072072072072072072072072072072072072072072072071071071071072072072072072072072072072072072072071071071071072072072072072072072072072072072072072072072072071071071071071071
072072072072072072072072072072072072072072072072072072072071071071071071072072072072072072072072072072072072072072072072071071071071071072072072072072072072072072072072072072072072072072072072
072072072072072072072072072072072071071071071071071071071071072072072072072072072072072072072072072072072072072072072072072072072072071071071071071071071071071072072072072072072072072072072072
072072072072072072072072071071071071072072072072072072072072072072072072072072072072072071072072072072071072072072072072072072072072072072072072072072072072071071071071072072072072072072072072
072072072072072072072072072072072072072072072072072072072072072072072072072072072072072071072072072072071072072072072072072072072072072072072072072072072072072072072072072072072072072072072072
072072072072072072072072072072072072072072072072072072072072072072072072072072072072071071071007007071071071072072072072072072072072072072072072072072072072072072072072072072072072072072072072
071071071071071071072072072072072072072072072072072072072072072072072072072072072072072072071007007071072072072072072072072072072072072072072072072072072072072072072072072072071071071071071071
071071071071071071071071071071071071071071071071071071071071071071071071071071071071071071071007007071071071071071071071071071071071071071071071071071071071071071071071071071071071071071071071
071071071071071071071071071071071071071071071071071071071071071071071071071071071071071071071071071071071071071071071071071071071071071071071071071071071071071071071071071071071071071071071071
071071071071071071071071071071071071071071071071071071071071071071071071071071071071071071071071071071071071071071071071071071071071071071071071071071071071071071071071071071071071071071071071
