071071071071071071071071071071071071071071071071071071071071071071071071071071071071071071071071
071071071071071071071071071071071071071071071071071071071071071071071071071071071071071071071071
071072072072072072072072072072072072072072072072072072072072072072072072072072072072072072072071
071007007072072072072072072072072072072072072072072072072072072072072072072072072072072072072071
071007007072072072072072072072072072072072072072072072072072072072072072072072072072072072072071
071007007072072072072072072072072072072072072072072072072072072072072072072072072072072072072071
071071071071071071071071071071071071071071071071071071071071071071071071071071072072072072072071
071072072072072072072072072072072072072072072072072072072072072072072072072072072072072072072071
071072072072072072072072072072072072072072072072072072072072072072072072072072072072072071071071
071072072072072072072072072072072072072072072072072072072072072072072072072072072072072071071071
071072072072072072072072072072072072072072072072072072072072072072072072072072072072072071071071
071072072072072072071071071071071071071071071071071071071071071071071071071071071071071071071071
071072072072072072072072072072072072072072072072072072072072072072072072072072072072072072072071
071071071072072072072072072072072072072072072072072072072072072072072072072072072072072072072071
071071071072072072072072072072072072072072072072072072072072072072072072072072072072072072072071
071071071072072072072072072072072072072072072072072072072072072072072072072072072072072072072071
071071071071071071071071071071071071071071071071071071071071071071071071071071072072072072072071
072072072072072072072072072072072072072072072072072072072072072072072072072072072072072072072071
072072072072072072072072072072072072072072072072072072072072072072072072072072072072072071071071
072072072072072072072072072072072072072072072072072072072072072072072072072072072072072071071071
072072072072072072072072072072072072072072072072072072072072072072072072072072072072072071071071
071071071071071071071071071071071071071071071071071071071071071071071071071071071071071071071071
071071071071071071071071071071071071071071071071071071071071071071071071071071071071071071071071
