071071071071071071071071071071071071071071071071071071071071071071071071071071071071071071071071071071071071071071071071071071071071071071071071
071071071071071071071071071071071071071071071071071071071071071071071071071071071071071071071071071071071071071071071071071071071071071071071071
071071071071071071071071071071071071071071071071071071071071071071071071071071071071071071071071071071071071071071071071071071071071071071071071
071071071071071071071071071071071071071071071071071071071071071071071071071071071071071071071071071071071071071071071071073073073071071071071071
071071071071071071071071071071071071071072072072072072072072072072072072072072072072072072072072072072072072072072072072072072072072072072072072
071071071071071071071071071071071071071072072072072072072072072072072072072072072072072072072072072072072072072072072072072072072072072072072072
071071071071071071071071071071071071071072072072072072072072072072072072072072072072072072072072072072072072072072072072072072072072072072072072
071071071071071071071071071071071071071072072072072072072072072072072072072072072072072072072072072072072072072072072072072072072072072072072072
071071071071071071071071071071071071071072072072072072072072072072072072072072072072072072072072072072072072072072072072072072071071071071071071
071071071071071071071071071071071071071072072072072072072072072072072072072072072072071072072072072072072072072072072072072072073071071071071071
071071071071071071071071071071071071071072072072072072072072072072072072072072072072071072072072072072072072072072072072072072073071071071071071
071071071071071071071071071071071071071072072072072072072072072072072072072072073073073072072072072072072072072072072072072072073071071071071071
071071071071071071071071071071071071071072072072072072072072072072072072072072072072072072072072072072072072072072072072072072071071071071071071
071071071071071071071071071071071071071072072072072072072072072072072072072072072072072072072072072072072072072072071071072072071071071071071071
071071071071071071071071071071071071071072072072072072072072072072072072072072072072072072072073072072072072072072072072072072071071071071071071
071071072072072072072072072072072072072072072072072072072072072072072072072072072072071071071073072072072072072072072072072072071071071071071071
071071072072072072072072072072072072072072072072072072072072072072072072072072072072072072072072072072072072072072072072072072071071071071071071
071071072072072072072072072072072072072072072072072072072072072072072072072072072072072072072072072072072072072072072072072072071071071071071071
071071072072072072072072072072072072072072072072072072072072072072072072072072072072072072072072072072072072072072072072072072072072072072071071
072072072072072072072072072072072072072072072072072072072072072072072072072072072072072072072072072072072072072072072072072072072072007007071071
072072072072072072072072072072072072072072072072072072072072072072072072072072072072072072072072072072072072072072072072072072072072007007071071
072072072072072072072072072072072072072072072072072072072072072072072072072072072072072072072072072072072072072072072072072072072072007007071071
071071071071071071071071071071071071071071071071071071071071071071071071071071071071071071071071071072072072072072072072072072071071071071071071
071071071071071071071071071071071071071071071071071071071071071071071071071071071071071071071072072072072072072072072072072072071071071071071071
071071071071071071071071071071071071071071071071071071071071071071071071071071071071071071071072072072072072072072072072072072071071071071071071
071071071071071071071071071071071071071071071071071071071071071071071071071071071071071071071072072072072072072072072072072072071071071071071071
071071071071071071071071071071071071071071071071071071071071071071071071071071071071071071071072072072072072072072072072072072071071071071071071
