071071071071071071071071071071071071071071071071071071071071071071071071071071071071071071071071071071071071071071071071071071071071071071071071
071071071071071071071071071071071071071071071071071071071071071071071071071071071071071071071071071071071071071071071071071071071071071071071071
071071072072072072072072072072072072072072071071072072072072072072072072072072071071071071071071071071071072072072072072072072072072072072071071
071071072072072072072072072072072072072072071071007007072072072072072072072072071071071071071071071071071072072072072072072072072072072072071071
071071072007007072072007007072072007007072071071007007072072072072072072072072071071071071071071071071071007007072072072072072072072007007071071
071071072007007072072007007072072007007072071071007007072072072072072072072072071071071071071071071071071007007072072072072072072072007007071071
071071072007007072072007007072072007007072071071071071072072072072072072072072071071071071071071071071071007007072072072072072072072007007071071
071071071071071071071071071071071071071071071071072072072072072072072072072072071071071071071071071071071071071071071071071071071071071071071071
071071071071071071071071071071071071071071071071072072072072072072072072072072071071071071071071071071071071071071071071071071071071071071071071
071071072072072072072072072072072072072072072072072072072072071071072072072072071071071071071071071071071072072072072007007072072072072071071071
071071072072072072072072072072072072072072072072072072072072072072072072072072071071071071071071071071071072072072072007007072072072072071071071
071071072072072072072072072072072072072072072072072072072072072072072072072072071071071071071071071071071072072072072007007072072072072071071071
071071072007007072072072072072072072072072007007072072072072072072072072071071071071071071071071071071071072072072072072072072072072072071071071
071071072007007072072072072072072072072072007007072072072072072072072072072072071071071071071071071071071072072072072072072072072072072071071071
071071072007007072072072072072072072072072007007072072072072072072072072072072072071071071071071071071071072072072072072072072072072072071071071
071071071071071071071071071071071071071071071071071071071071071071071071071071071071071071071071071071071072072072072072072072072072072071071071
071071071071071071071071071071071071071071071071071071071071071071071071071071071071071071071071071071071072072072072007007072072072072071071071
071071072072072072072072072072072072071071071071071071071071071071071071071071071071071071071071071071071072072072072007007072072072072071071071
071071072007007072072072072007007072071071071071071071071071071071071071071071071071071071071071071071071072072072072007007072072072072071071071
071071072007007072072072072007007072071071071071071071071071071071071071071071071071071071071071071071071072072072072072072072072072072071071071
071071072007007072072072072007007072071071071071071071071071071071071071071071071071071071071071071071071072072072072072072072072072072071071071
071071071071071071071071071071071071071071072072072072072072072072072072072072072072072072072072071071071072072072072072072072072072072071071071
071071071071071071071071071071071071071071072072072072072072072072072072072072072072072072072072071071071072072072072072072072072072072071071071
071071071071071071071071071071071071071071072072007007072072072072072072072072072072007007072072071071071072072072072007007072072072072071071071
071071071071071071071071071071071071071071072072007007072072072072072072072072072072007007072072071071071072072072072007007072072072072071071071
071071071071071071071071071071071071071071072072007007072072072072072072072072072072007007072072071071071072072072072007007072072072072071071071
071071071071071071071071071071071071071071071071071071071071071071071071071071071071071071071071071071071071071071071071071071071071071071071071
071071071071071071071071071071071071071071071071071071071071071071071071071071071071071071071071071071071071071071071071071071071071071071071071
