071071071071071071071071071071071071071071071071071071071071071071071071071071071071071071071071071071071071071071071071071071071071071071071071
071071071071071071071071071071071071071071071071071071071071071071071071071071071071071071071071071071071071071071071071071071071071071071071071
071071071071071071071071071071071071071071071071071071071071071071071071071071071071071071071071071071071071071071071071071071071071071071071071
071071071071072072072072072072072072072072072072072072072072072072072072072072072072072072072072072072072072071071071071071071071071071071071071
071071071071072072072072072072072072072072072072072072072072072072072072072072072072072072072072072072072072071071071071071071071071071071071071
071071071071072072072072072072072072072072072072072072072072072072072072072072072072072072072072072072072072071071071071071071071071071071071071
071071071071072072072072072072072072072072072072072072072072072072072072072072072072072072072072072072072072071071071071071071071071071071071071
071071071071072072072072072072072072072072072072072072072072072072072072072072072072072072072072072072072072071071071071071071071071071071071071
071071071071072072072072072072072072072072072072072072072072072072072072072072072072072072072072072072072072071071071071071071071071071071071071
071071071071072072072072072072072072072072072072072072072072072072072072072072072072072072072072072072072072071071071071071071071071071071071071
071071071071072072072072072072072072072072072072072072072072072072072072072072072072072072072072072072072072071071071071071071071071071071071071
071071071071072072072072072072072072072072072072072072072072072072072072072072072072072072072072072072072072071071071071071071071071071071071071
071071071071072007007072072072072072072072072072072072072072072072072072072072072072072072072072072072072072071071071071071071071071071071071071
071071071071072007007072072072072072072072072072072072072072072072072072072072072072072072072072072072072072072072072072072072072072072072072072
071071071072072007007072072072072072072072072072072072072072072072072072072072072072072072072072072072072072072072072072072072072072072072072072
071071071071071071071071071071071071071071071071071071071071071071071071071071071071071071071071071071071071071071071071071071071071071071071071
071071071071071071071071071071071071071071071071071071071071071071071071071071071071071071071071071071071071071071071071071071071071071071071071
071071071071071071071071071071071071071071071071071071071071071071071071071071071071071071071071071071071071071071071071071071071071071071071071
