000000000000000000000000000000000000000000000000000000000000000000000000000000000000000000000000000000000000000000000000000000000000000000000000000000000000000000000000000000000000000000000000
000000000000000000000000000000000000000000000000000000000000000000000000000000000000000000000000000000000000000000000000000000000000000000000000000000000000000000000000000000000000000000000000
000000000000000000000000000000000000000000000000000000000000000000000000000000000000000000000000000000000000000000000000000000000000000000000000000000000000000000000000000000000000000000000000
000000000014014014000000000000000000000000000000000000014014014000000000000000000000000000014014014014000000000014000000000000000000000000000000000000000000000000000000014014014014000000000000
000000014014014014000034000000000000000000000000000000014014014014000000000000000000000000014014014000000000034034000000000000000000000000000000000000000014014014014014014014014000000000000000
000000000000000034034034000000000000000000000000000000000000000000000000000000000000000000000000000000000034034036034000000000000000000000000000000000014014014014014014014014014000000000000000
000000000000034034034034000000000000000000000000000000000000000000000000000000000000000000000000000000034034036034034000000000000000000000000000000000014014014000000000000000000000000000000000
000000034034034034034034000000000000000034034000000000000000000000000000000000000000000000000000000034034034036034034034034000000000000000000000000000000000000000000000000000000000000000000000
000034034034034034034034034000000000034034034000000000000000000000000000000000000000000000000034034034034034034036034034034000000000000000000000000000000034034000000000000000000000000000034000
000034034034034034034034034034000000034034034034000000000000000000000000000000000000034034034034034034034034036036034034034034034000000000000000000000000034034034034000000000000000000034034034
034034034034034034034034034034000034034034034034034000000000000034034034034034034034034034034034034034036036036036036034034034034034034034034000000034034034034034034034034000000000034034034034
034034034034034034034034034034034034034034034034034034034034034034034034034034034034034034034034036036036036036036036036036036034034034034034034034034034034034034034034034034000034034034034034
035035035035035035035035035035035035035035035035035035035035035035035035035035035035035035035035035035035035035035035035035035035035035035035035035035035035035035035035035035035035035035035035
035035035035035035035035035035035035035035035035035035035035035035035035035035035035035035035035035035035035035035035035035035035035035035035035035035035035035035035035035035035035035035035035
035035035035035035035035035035035035035035035035035035035035035035035035035035035035035035035035035035035035035035035035035035035035035035035035035035035035035035035035035035035035035035035035
035035035035035035035035035035035035035035035035035035035035035035035035035035035035035035035035035035035035035035035035035035035035035035035035035035035035035035035035035035035035035035035035
012012012012012012012006006006012012012012012012012012012012012012012012012012012012012012012012006006006012012012012012012012012012012012012012012012012012012012012012012006006006012012012012
012012012012012012012006006006012012012012012012012012012012012012012012012012012012012012012012006006006012012012012012012012012012012012012012012012012012012012012012012006006006012012012012
