071071071071071071071071071071071071071071071071071071071071071071071071071071071071071071071071071071071071071071071071071071071071071071071071
071071071071071071071071071071071071071071071071071071071071071071071071071071071071071071071071071071071071071071071071071071071071071071071071
071071072072072072072072072072072072072072072072072072072072072072072072072072072072072072072072072072072072072072072072072072072072072072071071
071071072072072072072072072072072072072072072072072072000072000072000072000072000072000072000072000072014072000000000000000000000000000072071071
071071072072072072072072072072072072072072072072072072000072000072000072000072000072000072000072000072000072000014000000000014014013000072071071
071071072072072072072072072072072072072072072072072072000072000072000072000072000072014072014072000072000072000014014014000000014000000072071071
071071072072072072072072072072072072072072072072072072000072000072000072000072000072014072000072000072000072000000000000000000000000000072071071
071071072072072072072072072072072072072072072072072072000072000072000072000072000072000072000072000072000072000000000000000000000000000072071071
071071072072072072072072072072072072072072072072072072000072000072000072000072000072000072000072000072000072000000000000000000000000000072071071
071071072072072072072072072072072072072072072072072072012072012072012072012072012072012072012072012072012072012012012072072072072072072072071071
072072072072072072072072072072072072072072072072072072012072012072012072012072012072012072012072012072012072012072072072075075075075075075071071
072072072072072072072072072072072072072072072072072072012072012072012072012072012072012072012072012072012072072072075075075075075075075075071071
072072072072072072072072072072072072072072072072072072012072012072012072012072012072012072012072012072072072075075075075071071071071071071071071
072072072072072072072072072072072072072072072072072072012072012072012072012072012072012072012072072072075075075075071071071071071071071071071071
072072072072072072072072072072072072072072072072072072072072072072072072072072072072072072072072075075075075071071071071071071071071071071071071
071071071071071071071071071071071071071071071071071075075075075075075075075075075075075075075075075075071071071071071071071071071071071071071071
071071071071071071071071071071071071071071071071071075075075075075075075075075075075075075075075071071071071071071071071071071071071071071071071
071071071071071071071071071071071071071071071071071071071071071071071071071071071071071071071071071071071071071071071071071071071071071071071071
