033033033033033033033033033033033033033033033033033033033033033033033033033033033033033033033033
033033033033033033033033033033033033033033033033033033033033033033033033033033033033033033033033
033033033033033034034034034034034034034034034034034034034034034034034034034034034033033033033033
033033033034034034034034034034034034034034034034034034034034034034034034034034034034034033033033
033033033034034034034034034034034034034034034034034034034034034034034034034034034034034033033033
033033034034034034034034034034034034034034034034034034034034034034034034034034034034034034033033
033033034034034034034034034034034034034034034034034034034034034034034034034034034034034034033033
033033034034034034034034034034034034034034034034034034034034034034034034034034034034034034033033
033033034034034034034034034034034034034034034034034034034034034034034034034034034034034034033033
034034034034034034034034034034034034034034034007007034034034034034034034034034034034034034034034
034034034034034034034034034034034034034034034007007034034034034034034034034034034034034034034034
034034034034034034034034034034034034034034033007007033034034034034034034034034034034034034034034
034034034034034034034034034034034034033033033033033033033033034034034034034034034034034034034034
034034034034034034034034034034033033033033033033033033033033033033034034034034034034034034034034
034034034034034034033033033033033033033033033033033033033033033033033033033033034034034034034034
033033033033033033033033033033033033033033033033033033033033033033033033033033033033033033033033
033033033033033033033033033033033033033033033033033033033033033033033033033033033033033033033033
033033033033033033033033033033033033033033033033033033033033033033033033033033033033033033033033
