036036036036036036036036036036036036036036036036036036036036036036036036036036036036036002002002
036036036036036036036036036036036036036036036036036036036036036036036036036036036036036002002002
036036036036036036036036036036036036036036036036036036036036036036036036036036036036002002002002
036036036036036036036036036036036036036036036036036036036036036036036036036036036036002002002002
036036036036036036036036036036036036036036036036036036036036036036036036036036036002002002002002
036036036036036036036036036036036036036036036036036036036036036036036036036036036002002002002002
036036036036036036036036036036036036036036036036036036036036036036036036036036002002002002002002
036036036036036036036036036036036036036036036036036036036036036036036036036036002002002002002002
036036036036036036036036036036036036036036036036036036036036036036036036036002002002002002002002
036036036036036036036036036036036036036036036036036036036036036036036036036002002002002002002002
036036036036036036036036036036036036036036036036036036036036036036059036002002002002002002002002
036036036036036036036036036036036036036036036036036036036036036036036059002002002002002002002002
036036036036036040035035035035035035035035035035035035035035035035035010010010010010010010010010
036036036036036040035035035035035035035035035035035035035035035035035010010010010010010010010010
036036036036040035035035035035035035035035035035035035035035035035010010010010010010010010010010
036036036036040035035035035035035035035035035035035035035035035035010010010010010010010010010010
036036036036036036036036036036036036036036036036036036036036036002002002002002002002002002002002
036036036036036036036036036036036036036036036036036036036036036002002002002002002002002002002002
