000000000000000000000000000000000000000000000000000000000000000000000000000000000000000000000000000000000000000000000000000000000000000000000000000000000000000000000000000000000000000000000000
000000014014014000000000000014014014014000000000000000000000000000014014014000000000000014014014014014014000000000000000000000000000014014014014014000000000000000000000000000000000000000000000
000000014014014000000000000014014000000000000000000000000000000014014014014000000000014014014014000000000000000000000000000000000000000014014014014000000000000000000000000000000000000000000000
000000000000000000000000000000000000000000000000000000000000000000000000000000000000014014000000000000000000000000014014000000000000000000000000000000000000000000000000000000000000000000000000
000000000014014000000000000000000000000000000014014000000000000000000000000000000000000000000000000000000000000000000014000000000000000000000000000000000000014014000000000000000000000000000000
000000000000000000000000000000000000000000000000000000000000000000000000000000000000000000000000000000000000000000000000000000000000000000000000000000000000000000000000000000000000000000000000
036036036036036036036036036036036036036036036036036036036036036036036036036036036036036036036036036036036036036036036036036036036036036036036036036036004004004004004004004004004037036036036036
036036036036036036036036036036036036036036036036036036036036036036036036036036036036036036036036036036036036036036036036036036036036036036036036036036004040040040040040040040004037036036036036
036036036036036036036036036036036036036036036036036036036036036036036036036036036036036036036036036036036036036036036036036036036036036036036036036036004040039039040039039040004037036036036036
036036036036036036036004004004004004004004004004004004004037037036036036036004004004004004004004004004004004004004004004004004004004004037037037036036004040040040040040040040004037036036036036
036036036036036036036004040040040040040040040040040040004037037036036036036004040040040040040040040040040040040040040040040040040040004037037037036036004004004004004004004004004037036036036036
036036036036036036036004040040040040040040040040040040004037037036036036036004040040040040040040040040040040040040040040040040040040004037037037036036004040040040040040040040004037036036036036
008008008008008066008004040040007040040039039039040040004037037008008008008004040039039039039039039040015015040039039039039039039040004037037037008008004040039040007040039040004037008008008008
008008008008008067008004040040007040040040040040040040004037037008008008008004040040040040040040040040016016040040040040040040040040004037037037008008004040040040007040040040004037008008008008
002002002002002002002002002002002002002002002002002002002002002002002002002002002002002002002002002002002002002002002002002002002002002002002002002002002002002002002002002002002002002002002002
002002002002002002002002002002002002002002002002002002002002002002002002002002002002002002002002002002002002002002002002002002002002002002002002002002002002002002002002002002002002002002002002
002002002002002002002002002002002002002002002002002002002002002002002002002002002002002002002002002002002002002002002002002002002002002002002002002002002002002002002002002002002002002002002002
002002002002002002002002002002002002002002002002002002002002002002002002002002002002002002002002002002002002002002002002002002002002002002002002002002002002002002002002002002002002002002002002
