000000000000000000000000000000000000000000000000000000000000000000000000000000000000000000000000000000000000000000000000000000000000000000000000000000000000000000000000000000000000000000000000
000000000000000000000000000000014000000000000000000000000000000000000000000000000000000000000000000000000000000000000000000000000000000000014014014000000000000000000000000000000000000000000000
000000000000000000000000014014014014000000000000000000000000000000000000000014014014014000000000000000000000000000000000000000000000000000014014014000000000000000000000000000000000000000000000
000000000000000000000000014014014000000000014014014014000000000000000000000000014014000000000000014014014000000000000000000000000000000014014014014000000000000000000000000000000000000000000000
000000000000000000000000000000000000000000000014014014014000000000000000000000000000000000000000000014014014014000000000000000000000000000014014014000000000000000000000000000000000000000000000
000000000000000000000000000000000000000000000014014014014000000000000000000000000000000000000000000000000014014000000000000000000000000000000000000000000000000000000000000000000000000000000000
000000000000000000000000000000000000000000000000000000000000000000000000000000000000000000000000000000000000000000000000000000000000000000000000000000000000000000000000000000000000000000000000
000000000000000000000000000000000000000000000000000000000000000000000014014014014000000000000000000000000000000000000000000000000000000000000000000000000000000000000000000000000000000000000000
000000000000000000014014014014000000000000000000000000000000000000000000014000000000000000000000000000000000000000000000000000000000000014014000000000000000000000000000000000000000000000000000
000000000000000014014014014000000000000000000000000000000000000000000000000000000000000000000000000000000000000000000000000000000000000014014014000000000000000000000000000000000000000000000000
000000000000014014014000000000000000000000000000000000000000000000000000000000000000000000000000000000000000000000000000000000000000000000000000000000000000000000000000000000000000000000000000
000000000000000000000000000000000000000000000000000000000000000000000000000000000000000000000000000000000000000000000000000000000000000000000000000000000000000014014000000000000000000000000000
000000000014000000000000000000000000000000014000000000000000000000000000000000000000000000000000000000014000000000000014014000000000000000000000000000000000000000000000000000000000000000000000
000000014014000000000000000000000000000000014014000000000000000000000000000000014014014000000000000000014000000000000000014000000000014000000000000000000000000000000000000000000000014014000000
000000000000000000000000000000000000000000000000000000000000000000038054038000000000000000000000000000000000000000000000000000000000000000000000000000000000000000000000000000000000000000000000
036036036036036036036036036036036036036036036036036036036036036038038038038038036036036036036036036036036036036036036036036036036036036036036036036036036036036036036036036036036036036036036036
036036036036036036036036036036036036036036036036036036036036038038035035035038038036036036036036036036036036036036036036036036036036036036036036036036036036036036036036036036036036036036036036
036036036036036036036036036036036036036036036036036036036038038035035035035035038038036036036036036036036036036036036038038004004004004004004004038036036036036036036036036036036036036036036036
036036036036036037038038038038038038038038038036036038038038038038038038038038038038038038036036036036036036036036036038035035035035035035035035004036036036036036036036036036036036036036036036
036036036036036037004037037037037037037037004036036036004040040040040040040040040040004036036036036036036036036036036038035035035035035035035035004036036036036036036036036036036036036036036036
036036036036036038004037037037037037037037004036036036004040040040040040040040040040004036036036036036036036036036036038035035035035035035035035004036036036036036036036036036036036036036036036
008008008008008037004037037037015037037037004008008008004040040040040007040040040040004008008008008008008008008008008015035035035035035035035035015036036036036036036036036036036036036036036036
008008008008008037004037037037016037037037004008008008004040040040040007040040040040004008008008008008008008008008008016035035035035035035035035016035035035035035035035035035035035035035035035
002002002002002002002002002002002002002002002002002002002002002002002002002002002002002002002002002002002002002002002038038004004004004004004004004035035035035035035035035035035035035035035035
002002002002002002002002002002002002002002002002002002002002002002002002002002002002002002002002002002002002002002002012004004012004004012004004012012012006006012012006006012012006006012012006
002002002002002002002002002002002002002002002002002002002002002002002002002002002002002002002002002002002002002002002012004004012004004012004004012012012006006012012006006012012006006012012006
002002002002002002002002002002002002002002002002002002002002002002002002002002002002002002002002002002002002002002002012004004012004004012004004012012012006006012012006006012012006006012012006
